genus	class	phylum
Cellvibrio	Gammaproteobacteria	Pseudomonadota
Ancylobacter	Alphaproteobacteria	Pseudomonadota
Cryobacterium	Actinomycetes	Actinomycetota
Cupriavidus	Betaproteobacteria	Pseudomonadota
Pigmentiphaga	Betaproteobacteria	Pseudomonadota
Methylovorus	Betaproteobacteria	Pseudomonadota
Austwickia	Actinomycetes	Actinomycetota
NA	Planctomycetia	Planctomycetota
Halopseudomonas	Gammaproteobacteria	Pseudomonadota
Occallatibacter	Terriglobia	Acidobacteriota
Gaiella	Rubrobacteria	Actinomycetota
Thermoflexibacter	Cytophagia	Bacteroidota
Methylobacterium	Alphaproteobacteria	Pseudomonadota
Streptantibioticus	Actinomycetes	Actinomycetota
Alicyclobacillus	Bacilli	Bacillota
Chitinophaga	Chitinophagia	Bacteroidota
Mesorhizobium	Alphaproteobacteria	Pseudomonadota
Hydrotalea	Chitinophagia	Bacteroidota
Ferruginibacter	Chitinophagia	Bacteroidota
Collimonas	Betaproteobacteria	Pseudomonadota
Phormidesmis	Cyanophyceae	Cyanobacteriota
Aminivibrio	Synergistia	Synergistota
Roseovarius	Alphaproteobacteria	Pseudomonadota
Nocardioides	Actinomycetes	Actinomycetota
Buttiauxella	Gammaproteobacteria	Pseudomonadota
Aeromonas	Gammaproteobacteria	Pseudomonadota
Paenibacillus	Bacilli	Bacillota
Pusillimonas	Betaproteobacteria	Pseudomonadota
Magnetospirillum	Alphaproteobacteria	Pseudomonadota
Sphingobium	Alphaproteobacteria	Pseudomonadota
Coprobacillus	Erysipelotrichia	Bacillota
Acetonema	Negativicutes	Bacillota
Jeongeupia	Betaproteobacteria	Pseudomonadota
Comamonas	Betaproteobacteria	Pseudomonadota
Flectobacillus	Cytophagia	Bacteroidota
Sphingobacterium	Sphingobacteriia	Bacteroidota
Thalassovita	Alphaproteobacteria	Pseudomonadota
Rhodococcus	Actinomycetes	Actinomycetota
Burkholderia	Betaproteobacteria	Pseudomonadota
Capnocytophaga	Flavobacteriia	Bacteroidota
Camelimonas	Alphaproteobacteria	Pseudomonadota
Collinsella	Coriobacteriia	Actinomycetota
Xenococcus	Cyanophyceae	Cyanobacteriota
Cyanobacterium	Cyanophyceae	Cyanobacteriota
Endozoicomonas	Gammaproteobacteria	Pseudomonadota
Pontixanthobacter	Alphaproteobacteria	Pseudomonadota
Shewanella	Gammaproteobacteria	Pseudomonadota
Neorhizobium	Alphaproteobacteria	Pseudomonadota
Pseudomonas	Gammaproteobacteria	Pseudomonadota
Amnibacterium	Actinomycetes	Actinomycetota
Hyphomicrobium	Alphaproteobacteria	Pseudomonadota
Thiothrix	Gammaproteobacteria	Pseudomonadota
Sphingomonas	Alphaproteobacteria	Pseudomonadota
Streptomyces	Actinomycetes	Actinomycetota
Bremerella	Planctomycetia	Planctomycetota
Tropicimonas	Alphaproteobacteria	Pseudomonadota
Extensimonas	Betaproteobacteria	Pseudomonadota
Malaciobacter	Epsilonproteobacteria	Campylobacterota
Nonomuraea	Actinomycetes	Actinomycetota
Microlunatus	Actinomycetes	Actinomycetota
Neisseria	Betaproteobacteria	Pseudomonadota
Afipia	Alphaproteobacteria	Pseudomonadota
Microvirga	Alphaproteobacteria	Pseudomonadota
Salinisphaera	Gammaproteobacteria	Pseudomonadota
Marinobacter	Gammaproteobacteria	Pseudomonadota
Thioalkalivibrio	Gammaproteobacteria	Pseudomonadota
Variovorax	Betaproteobacteria	Pseudomonadota
Aminobacter	Alphaproteobacteria	Pseudomonadota
Pseudoduganella	Betaproteobacteria	Pseudomonadota
Actinoplanes	Actinomycetes	Actinomycetota
Advenella	Betaproteobacteria	Pseudomonadota
Bosea	Alphaproteobacteria	Pseudomonadota
NA	NA	Acidobacteriota
Actinokineospora	Actinomycetes	Actinomycetota
Pelagimonas	Alphaproteobacteria	Pseudomonadota
Janibacter	Actinomycetes	Actinomycetota
Bordetella	Betaproteobacteria	Pseudomonadota
Azorhizobium	Alphaproteobacteria	Pseudomonadota
Bradyrhizobium	Alphaproteobacteria	Pseudomonadota
Cyclobacterium	Cytophagia	Bacteroidota
Acetobacter	Alphaproteobacteria	Pseudomonadota
Erythrobacter	Alphaproteobacteria	Pseudomonadota
Ensifer	Alphaproteobacteria	Pseudomonadota
Marinobacterium	Gammaproteobacteria	Pseudomonadota
Tenacibaculum	Flavobacteriia	Bacteroidota
Kutzneria	Actinomycetes	Actinomycetota
Pseudoxanthomonas	Gammaproteobacteria	Pseudomonadota
NA	Gammaproteobacteria	Pseudomonadota
Marichromatium	Gammaproteobacteria	Pseudomonadota
Sporichthya	Actinomycetes	Actinomycetota
Fusibacter	Clostridia	Bacillota
Aliidiomarina	Gammaproteobacteria	Pseudomonadota
Rhizobium	Alphaproteobacteria	Pseudomonadota
Allochromatium	Gammaproteobacteria	Pseudomonadota
Leptospira	Spirochaetia	Spirochaetota
Runella	Cytophagia	Bacteroidota
Allobaculum	Erysipelotrichia	Bacillota
Thiomonas	Betaproteobacteria	Pseudomonadota
Ectothiorhodospira	Gammaproteobacteria	Pseudomonadota
Saccharothrix	Actinomycetes	Actinomycetota
Halorhodospira	Gammaproteobacteria	Pseudomonadota
Ralstonia	Betaproteobacteria	Pseudomonadota
Klenkia	Actinomycetes	Actinomycetota
Streptacidiphilus	Actinomycetes	Actinomycetota
Gemmobacter	Alphaproteobacteria	Pseudomonadota
Rivihabitans	Betaproteobacteria	Pseudomonadota
Luteimicrobium	Actinomycetes	Actinomycetota
Methylotenera	Betaproteobacteria	Pseudomonadota
Nitrosococcus	Gammaproteobacteria	Pseudomonadota
Methylibium	Betaproteobacteria	Pseudomonadota
Thiocapsa	Gammaproteobacteria	Pseudomonadota
Stutzerimonas	Gammaproteobacteria	Pseudomonadota
Nocardia	Actinomycetes	Actinomycetota
Teredinibacter	Gammaproteobacteria	Pseudomonadota
Thiococcus	Gammaproteobacteria	Pseudomonadota
Rhodobacter	Alphaproteobacteria	Pseudomonadota
Pelistega	Betaproteobacteria	Pseudomonadota
Cereibacter	Alphaproteobacteria	Pseudomonadota
Rhodocyclus	Betaproteobacteria	Pseudomonadota
Streptosporangium	Actinomycetes	Actinomycetota
Lamprobacter	Gammaproteobacteria	Pseudomonadota
Acinetobacter	Gammaproteobacteria	Pseudomonadota
Rhodomicrobium	Alphaproteobacteria	Pseudomonadota
Amycolatopsis	Actinomycetes	Actinomycetota
Mycolicibacillus	Actinomycetes	Actinomycetota
Spirosoma	Cytophagia	Bacteroidota
Glomeribacter	Betaproteobacteria	Pseudomonadota
Periweissella	Bacilli	Bacillota
Acrocarpospora	Actinomycetes	Actinomycetota
Polymorphobacter	Alphaproteobacteria	Pseudomonadota
Bailinhaonella	Actinomycetes	Actinomycetota
Geodermatophilus	Actinomycetes	Actinomycetota
Microbacterium	Actinomycetes	Actinomycetota
Rhodopila	Alphaproteobacteria	Pseudomonadota
Caballeronia	Betaproteobacteria	Pseudomonadota
Bacillus	Bacilli	Bacillota
Chromobacterium	Betaproteobacteria	Pseudomonadota
Halomonas	Gammaproteobacteria	Pseudomonadota
Rhodopseudomonas	Alphaproteobacteria	Pseudomonadota
Pseudoalteromonas	Gammaproteobacteria	Pseudomonadota
Eikenella	Betaproteobacteria	Pseudomonadota
Porticoccus	Gammaproteobacteria	Pseudomonadota
Carnobacterium	Bacilli	Bacillota
Mycolicibacter	Actinomycetes	Actinomycetota
Gordonia	Actinomycetes	Actinomycetota
Rossellomorea	Bacilli	Bacillota
Rhodoblastus	Alphaproteobacteria	Pseudomonadota
Cronobacter	Gammaproteobacteria	Pseudomonadota
Brachybacterium	Actinomycetes	Actinomycetota
Fuscovulum	Alphaproteobacteria	Pseudomonadota
Janthinobacterium	Betaproteobacteria	Pseudomonadota
Phytohabitans	Actinomycetes	Actinomycetota
Methylosinus	Alphaproteobacteria	Pseudomonadota
Glycomyces	Actinomycetes	Actinomycetota
Rhodanobacter	Gammaproteobacteria	Pseudomonadota
Pantoea	Gammaproteobacteria	Pseudomonadota
Thiolapillus	Gammaproteobacteria	Pseudomonadota
Allofranklinella	Betaproteobacteria	Pseudomonadota
Fontimonas	Gammaproteobacteria	Pseudomonadota
Opitutus	Opitutae	Verrucomicrobiota
Dietzia	Actinomycetes	Actinomycetota
Paracoccus	Alphaproteobacteria	Pseudomonadota
Pseudorhodobacter	Alphaproteobacteria	Pseudomonadota
Paenisporosarcina	Bacilli	Bacillota
Serinicoccus	Actinomycetes	Actinomycetota
Herbaspirillum	Betaproteobacteria	Pseudomonadota
Methylovulum	Gammaproteobacteria	Pseudomonadota
Blastochloris	Alphaproteobacteria	Pseudomonadota
Leucobacter	Actinomycetes	Actinomycetota
Afifella	Alphaproteobacteria	Pseudomonadota
Leptolyngbya	Cyanophyceae	Cyanobacteriota
Veronia	Gammaproteobacteria	Pseudomonadota
Neoroseomonas	Alphaproteobacteria	Pseudomonadota
Limimonas	Alphaproteobacteria	Pseudomonadota
Dyadobacter	Cytophagia	Bacteroidota
Lonsdalea	Gammaproteobacteria	Pseudomonadota
Pelagibacterium	Alphaproteobacteria	Pseudomonadota
Rhodospirillum	Alphaproteobacteria	Pseudomonadota
Gluconacetobacter	Alphaproteobacteria	Pseudomonadota
Propioniciclava	Actinomycetes	Actinomycetota
Rhodothalassium	Alphaproteobacteria	Pseudomonadota
Sediminibacterium	Chitinophagia	Bacteroidota
Rhodovibrio	Alphaproteobacteria	Pseudomonadota
Novosphingobium	Alphaproteobacteria	Pseudomonadota
Thermoactinospora	Actinomycetes	Actinomycetota
Dickeya	Gammaproteobacteria	Pseudomonadota
Actinopolyspora	Actinomycetes	Actinomycetota
Salisaeta	Rhodothermia	Rhodothermota
Geminicoccus	Alphaproteobacteria	Pseudomonadota
Nakamurella	Actinomycetes	Actinomycetota
Alishewanella	Gammaproteobacteria	Pseudomonadota
Methylotuvimicrobium	Gammaproteobacteria	Pseudomonadota
Alloalcanivorax	Gammaproteobacteria	Pseudomonadota
Bartonella	Alphaproteobacteria	Pseudomonadota
Demequina	Actinomycetes	Actinomycetota
Methylobacter	Gammaproteobacteria	Pseudomonadota
Devosia	Alphaproteobacteria	Pseudomonadota
Defluviimonas	Alphaproteobacteria	Pseudomonadota
Patulibacter	Thermoleophilia	Actinomycetota
Limnohabitans	Betaproteobacteria	Pseudomonadota
Arthrobacter	Actinomycetes	Actinomycetota
Methylopila	Alphaproteobacteria	Pseudomonadota
Tepidimonas	Betaproteobacteria	Pseudomonadota
Altererythrobacter	Alphaproteobacteria	Pseudomonadota
Lysobacter	Gammaproteobacteria	Pseudomonadota
Segeticoccus	Actinomycetes	Actinomycetota
Agriterribacter	Chitinophagia	Bacteroidota
Mycobacterium	Actinomycetes	Actinomycetota
Kribbella	Actinomycetes	Actinomycetota
Paenirhodobacter	Alphaproteobacteria	Pseudomonadota
Mycolicibacterium	Actinomycetes	Actinomycetota
Leifsonia	Actinomycetes	Actinomycetota
Agreia	Actinomycetes	Actinomycetota
Brenneria	Gammaproteobacteria	Pseudomonadota
Verminephrobacter	Betaproteobacteria	Pseudomonadota
Tistrella	Alphaproteobacteria	Pseudomonadota
Porphyromonas	Bacteroidia	Bacteroidota
Herminiimonas	Betaproteobacteria	Pseudomonadota
Flavobacterium	Flavobacteriia	Bacteroidota
Massilia	Betaproteobacteria	Pseudomonadota
Sedimenticola	Gammaproteobacteria	Pseudomonadota
Methylophilus	Betaproteobacteria	Pseudomonadota
Methylomicrobium	Gammaproteobacteria	Pseudomonadota
Albimonas	Alphaproteobacteria	Pseudomonadota
Piscinibacter	Betaproteobacteria	Pseudomonadota
Muricauda	Flavobacteriia	Bacteroidota
Kineosphaera	Actinomycetes	Actinomycetota
Hoeflea	Alphaproteobacteria	Pseudomonadota
Methyloglobulus	Gammaproteobacteria	Pseudomonadota
NA	NA	Cyanobacteriota
Xanthobacter	Alphaproteobacteria	Pseudomonadota
Neobacillus	Bacilli	Bacillota
Simiduia	Gammaproteobacteria	Pseudomonadota
Marinifilum	Bacteroidia	Bacteroidota
Stanieria	Cyanophyceae	Cyanobacteriota
Picosynechococcus	Cyanophyceae	Cyanobacteriota
Actinomadura	Actinomycetes	Actinomycetota
Brevibacillus	Bacilli	Bacillota
Thermomonospora	Actinomycetes	Actinomycetota
Stenotrophomonas	Gammaproteobacteria	Pseudomonadota
Defluviicoccus	Alphaproteobacteria	Pseudomonadota
Ciceribacter	Alphaproteobacteria	Pseudomonadota
Undibacterium	Betaproteobacteria	Pseudomonadota
Methyloversatilis	Betaproteobacteria	Pseudomonadota
Ignatzschineria	Gammaproteobacteria	Pseudomonadota
Achromobacter	Betaproteobacteria	Pseudomonadota
Aquamicrobium	Alphaproteobacteria	Pseudomonadota
Sphingopyxis	Alphaproteobacteria	Pseudomonadota
Acetitomaculum	Clostridia	Bacillota
Acidocella	Alphaproteobacteria	Pseudomonadota
Actinomycetospora	Actinomycetes	Actinomycetota
Actinopolymorpha	Actinomycetes	Actinomycetota
Ahrensia	Alphaproteobacteria	Pseudomonadota
Algoriphagus	Cytophagia	Bacteroidota
Aliagarivorans	Gammaproteobacteria	Pseudomonadota
Effusibacillus	Bacilli	Bacillota
Alkanindiges	Gammaproteobacteria	Pseudomonadota
Amorphus	Alphaproteobacteria	Pseudomonadota
Andreprevotia	Betaproteobacteria	Pseudomonadota
Aneurinibacillus	Bacilli	Bacillota
Aquaspirillum	Betaproteobacteria	Pseudomonadota
Arenimonas	Gammaproteobacteria	Pseudomonadota
Asticcacaulis	Alphaproteobacteria	Pseudomonadota
Aureimonas	Alphaproteobacteria	Pseudomonadota
Parazoarcus	Betaproteobacteria	Pseudomonadota
Azohydromonas	Betaproteobacteria	Pseudomonadota
Azonexus	Betaproteobacteria	Pseudomonadota
Azospirillum	Alphaproteobacteria	Pseudomonadota
Azovibrio	Betaproteobacteria	Pseudomonadota
Ectobacillus	Bacilli	Bacillota
Belnapia	Alphaproteobacteria	Pseudomonadota
Brachymonas	Betaproteobacteria	Pseudomonadota
Brevundimonas	Alphaproteobacteria	Pseudomonadota
Caenimonas	Betaproteobacteria	Pseudomonadota
Caloranaerobacter	Tissierellia	Bacillota
Chitinilyticum	Betaproteobacteria	Pseudomonadota
Chitinimonas	Betaproteobacteria	Pseudomonadota
Epilithonimonas	Flavobacteriia	Bacteroidota
Clostridium	Clostridia	Bacillota
Paramaledivibacter	Clostridia	Bacillota
Ruminiclostridium	Clostridia	Bacillota
Asaccharospora	Clostridia	Bacillota
Anaerocolumna	Clostridia	Bacillota
Cohnella	Bacilli	Bacillota
Conchiformibius	Betaproteobacteria	Pseudomonadota
Corynebacterium	Actinomycetes	Actinomycetota
Cytophaga	Cytophagia	Bacteroidota
Deefgea	Betaproteobacteria	Pseudomonadota
Deinococcus	Deinococci	Deinococcota
Derxia	Betaproteobacteria	Pseudomonadota
Desulfacinum	Syntrophobacteria	Thermodesulfobacteriota
Desulfatibacillum	Desulfobacteria	Thermodesulfobacteriota
Desulfatirhabdium	Desulfobacteria	Thermodesulfobacteriota
Desulfitobacterium	Clostridia	Bacillota
Desulfobacter	Desulfobacteria	Thermodesulfobacteriota
Desulfatiglans	Desulfobacteria	Thermodesulfobacteriota
Desulfobulbus	Desulfobulbia	Thermodesulfobacteriota
Desulfogranum	Desulfobulbia	Thermodesulfobacteriota
Desulfomicrobium	Desulfovibrionia	Thermodesulfobacteriota
Desulfopila	Desulfobulbia	Thermodesulfobacteriota
Desulfosporosinus	Clostridia	Bacillota
Desulforamulus	Clostridia	Bacillota
Desulfofalx	Clostridia	Bacillota
Desulfotruncus	Clostridia	Bacillota
Desulfoscipio	Clostridia	Bacillota
Desulfallas	Clostridia	Bacillota
Desulfofundulus	Clostridia	Bacillota
Solidesulfovibrio	Desulfovibrionia	Thermodesulfobacteriota
Alkalidesulfovibrio	Desulfovibrionia	Thermodesulfobacteriota
Desulfovibrio	Desulfovibrionia	Thermodesulfobacteriota
Maridesulfovibrio	Desulfovibrionia	Thermodesulfobacteriota
Paucidesulfovibrio	Desulfovibrionia	Thermodesulfobacteriota
Fundidesulfovibrio	Desulfovibrionia	Thermodesulfobacteriota
Fodinicurvata	Alphaproteobacteria	Pseudomonadota
Edaphobacter	Terriglobia	Acidobacteriota
Elioraea	Alphaproteobacteria	Pseudomonadota
Enterovibrio	Gammaproteobacteria	Pseudomonadota
Ferrimonas	Gammaproteobacteria	Pseudomonadota
Geopsychrobacter	Desulfuromonadia	Thermodesulfobacteriota
Geothrix	Holophagae	Acidobacteriota
Haliea	Gammaproteobacteria	Pseudomonadota
Hamadaea	Actinomycetes	Actinomycetota
Hymenobacter	Cytophagia	Bacteroidota
Inquilinus	Alphaproteobacteria	Pseudomonadota
Kaistia	Alphaproteobacteria	Pseudomonadota
Kushneria	Gammaproteobacteria	Pseudomonadota
Lachnobacterium	Clostridia	Bacillota
Lampropedia	Betaproteobacteria	Pseudomonadota
Leeia	Betaproteobacteria	Pseudomonadota
Yoonia	Alphaproteobacteria	Pseudomonadota
Luteimonas	Gammaproteobacteria	Pseudomonadota
Lutispora	Clostridia	Bacillota
Marinactinospora	Actinomycetes	Actinomycetota
Marinimicrobium	Gammaproteobacteria	Pseudomonadota
Marinitoga	Thermotogae	Thermotogota
Marinospirillum	Gammaproteobacteria	Pseudomonadota
Martelella	Alphaproteobacteria	Pseudomonadota
Neomegalonema	Alphaproteobacteria	Pseudomonadota
Calidithermus	Deinococci	Deinococcota
Spongiibacter	Gammaproteobacteria	Pseudomonadota
Microvirgula	Betaproteobacteria	Pseudomonadota
Moraxella	Gammaproteobacteria	Pseudomonadota
Phreatobacter	Alphaproteobacteria	Pseudomonadota
Nevskia	Gammaproteobacteria	Pseudomonadota
Niabella	Chitinophagia	Bacteroidota
Nisaea	Alphaproteobacteria	Pseudomonadota
Oceanobacter	Gammaproteobacteria	Pseudomonadota
Oceanospirillum	Gammaproteobacteria	Pseudomonadota
Ottowia	Betaproteobacteria	Pseudomonadota
Pedobacter	Sphingobacteriia	Bacteroidota
Pelobacter	Desulfuromonadia	Thermodesulfobacteriota
Pleomorphomonas	Alphaproteobacteria	Pseudomonadota
Chlorogloeopsis	Cyanophyceae	Cyanobacteriota
Pseudogulbenkiania	Betaproteobacteria	Pseudomonadota
Pseudonocardia	Actinomycetes	Actinomycetota
Pseudoxanthobacter	Alphaproteobacteria	Pseudomonadota
Telmatocola	Planctomycetia	Planctomycetota
Arsukibacterium	Gammaproteobacteria	Pseudomonadota
Rheinheimera	Gammaproteobacteria	Pseudomonadota
Falsiroseomonas	Alphaproteobacteria	Pseudomonadota
Rubellimicrobium	Alphaproteobacteria	Pseudomonadota
Rubritepida	Alphaproteobacteria	Pseudomonadota
Rudaea	Gammaproteobacteria	Pseudomonadota
Saccharospirillum	Gammaproteobacteria	Pseudomonadota
Salinarimonas	Alphaproteobacteria	Pseudomonadota
Salinimonas	Gammaproteobacteria	Pseudomonadota
Sandarakinorhabdus	Alphaproteobacteria	Pseudomonadota
Schlesneria	Planctomycetia	Planctomycetota
Sciscionella	Actinomycetes	Actinomycetota
Sediminimonas	Alphaproteobacteria	Pseudomonadota
Segetibacter	Chitinophagia	Bacteroidota
Silanimonas	Gammaproteobacteria	Pseudomonadota
Simplicispira	Betaproteobacteria	Pseudomonadota
Solimonas	Gammaproteobacteria	Pseudomonadota
Sediminispirochaeta	Spirochaetia	Spirochaetota
Sporobacter	Clostridia	Bacillota
Stappia	Alphaproteobacteria	Pseudomonadota
Stenoxybacter	Betaproteobacteria	Pseudomonadota
Streptococcus	Bacilli	Bacillota
Sulfurihydrogenibium	Aquificae	Aquificota
Tepidiphilus	Hydrogenophilia	Pseudomonadota
Terasakiella	Alphaproteobacteria	Pseudomonadota
Terrimonas	Chitinophagia	Bacteroidota
Litoreibacter	Alphaproteobacteria	Pseudomonadota
Thermithiobacillus	Acidithiobacillia	Pseudomonadota
Thiobacillus	Betaproteobacteria	Pseudomonadota
Thiohalospira	Gammaproteobacteria	Pseudomonadota
Thiofilum	Gammaproteobacteria	Pseudomonadota
Uliginosibacterium	Betaproteobacteria	Pseudomonadota
Vibrio	Gammaproteobacteria	Pseudomonadota
Xenophilus	Betaproteobacteria	Pseudomonadota
Zavarzinella	Planctomycetia	Planctomycetota
Propionispira	Negativicutes	Bacillota
Thiomicrorhabdus	Gammaproteobacteria	Pseudomonadota
Microcystis	Cyanophyceae	Cyanobacteriota
Deferrisoma	Deferrisomatia	Thermodesulfobacteriota
Halpernia	Flavobacteriia	Bacteroidota
Limimaricola	Alphaproteobacteria	Pseudomonadota
Polycladomyces	Bacilli	Bacillota
Escherichia	Gammaproteobacteria	Pseudomonadota
Saccharomonospora	Actinomycetes	Actinomycetota
Synechococcus	Cyanophyceae	Cyanobacteriota
Sporomusa	Negativicutes	Bacillota
Kyrpidia	Bacilli	Bacillota
Neochlamydia	Chlamydiia	Chlamydiota
Nitrolancea	Thermomicrobia	Thermomicrobiota
Gemmata	Planctomycetia	Planctomycetota
NA	NA	NA
Methylomonas	Gammaproteobacteria	Pseudomonadota
Chromatocurvus	Gammaproteobacteria	Pseudomonadota
Methylosarcina	Gammaproteobacteria	Pseudomonadota
Methylocystis	Alphaproteobacteria	Pseudomonadota
Plasticicumulans	Gammaproteobacteria	Pseudomonadota
Bacteroides	Bacteroidia	Bacteroidota
Hansschlegelia	Alphaproteobacteria	Pseudomonadota
Marinicauda	Alphaproteobacteria	Pseudomonadota
Verrucomicrobium	Verrucomicrobiae	Verrucomicrobiota
NA	NA	Ignavibacteriota
Thauera	Betaproteobacteria	Pseudomonadota
Polaribacter	Flavobacteriia	Bacteroidota
Allokutzneria	Actinomycetes	Actinomycetota
Chryseobacterium	Flavobacteriia	Bacteroidota
Synechocystis	Cyanophyceae	Cyanobacteriota
Rickettsia	Alphaproteobacteria	Pseudomonadota
Thalassotalea	Gammaproteobacteria	Pseudomonadota
Caulobacter	Alphaproteobacteria	Pseudomonadota
Acidovorax	Betaproteobacteria	Pseudomonadota
Polaromonas	Betaproteobacteria	Pseudomonadota
Micromonospora	Actinomycetes	Actinomycetota
Luteolibacter	Verrucomicrobiae	Verrucomicrobiota
Paludibacterium	Betaproteobacteria	Pseudomonadota
Alkaliphilus	Clostridia	Bacillota
Blastococcus	Actinomycetes	Actinomycetota
Phyllobacterium	Alphaproteobacteria	Pseudomonadota
NA	Cyanophyceae	Cyanobacteriota
Pararhodospirillum	Alphaproteobacteria	Pseudomonadota
Arcticibacter	Sphingobacteriia	Bacteroidota
Tsukamurella	Actinomycetes	Actinomycetota
Pseudanabaena	Cyanophyceae	Cyanobacteriota
Spirulina	Cyanophyceae	Cyanobacteriota
Moorena	Cyanophyceae	Cyanobacteriota
Desulfotignum	Desulfobacteria	Thermodesulfobacteriota
Trichlorobacter	Desulfuromonadia	Thermodesulfobacteriota
Chlorobaculum	Chlorobiia	Chlorobiota
Paenimyroides	Flavobacteriia	Bacteroidota
Niallia	Bacilli	Bacillota
Planktothrix	Cyanophyceae	Cyanobacteriota
Ruminococcus	Clostridia	Bacillota
Auritidibacter	Actinomycetes	Actinomycetota
Helcobacillus	Actinomycetes	Actinomycetota
Euryhalocaulis	Alphaproteobacteria	Pseudomonadota
Maritimibacter	Alphaproteobacteria	Pseudomonadota
Angustibacter	Actinomycetes	Actinomycetota
Cohaesibacter	Alphaproteobacteria	Pseudomonadota
Sulfuricella	Betaproteobacteria	Pseudomonadota
Mycetocola	Actinomycetes	Actinomycetota
Melaminivora	Betaproteobacteria	Pseudomonadota
Fibrella	Cytophagia	Bacteroidota
Pseudomaricurvus	Gammaproteobacteria	Pseudomonadota
Thiodictyon	Gammaproteobacteria	Pseudomonadota
Desulfocapsa	Desulfobulbia	Thermodesulfobacteriota
Draconibacterium	Bacteroidia	Bacteroidota
Tangfeifania	Bacteroidia	Bacteroidota
Marinilabilia	Bacteroidia	Bacteroidota
Azomonas	Gammaproteobacteria	Pseudomonadota
Vulcaniibacterium	Gammaproteobacteria	Pseudomonadota
Caldicoprobacter	Clostridia	Bacillota
Candidatus Methylomirabilis	NA	candidate division NC10
Calothrix	Cyanophyceae	Cyanobacteriota
Cylindrospermopsis	Cyanophyceae	Cyanobacteriota
Promicromonospora	Actinomycetes	Actinomycetota
Terracoccus	Actinomycetes	Actinomycetota
Hydrocarboniphaga	Gammaproteobacteria	Pseudomonadota
Conyzicola	Actinomycetes	Actinomycetota
Chamaesiphon	Cyanophyceae	Cyanobacteriota
Crinalium	Cyanophyceae	Cyanobacteriota
Fischerella	Cyanophyceae	Cyanobacteriota
Geitlerinema	Cyanophyceae	Cyanobacteriota
Gloeocapsa	Cyanophyceae	Cyanobacteriota
Allocoleopsis	Cyanophyceae	Cyanobacteriota
Lihuaxuella	Bacilli	Bacillota
Ruegeria	Alphaproteobacteria	Pseudomonadota
Parvularcula	Alphaproteobacteria	Pseudomonadota
Aphanizomenon	Cyanophyceae	Cyanobacteriota
Kocuria	Actinomycetes	Actinomycetota
Sphingosinicella	Alphaproteobacteria	Pseudomonadota
Planomicrobium	Bacilli	Bacillota
Agrobacterium	Alphaproteobacteria	Pseudomonadota
Nostoc	Cyanophyceae	Cyanobacteriota
Alcanivorax	Gammaproteobacteria	Pseudomonadota
Methyloligella	Alphaproteobacteria	Pseudomonadota
Thalassospira	Alphaproteobacteria	Pseudomonadota
Paracidovorax	Betaproteobacteria	Pseudomonadota
Endobacter	Alphaproteobacteria	Pseudomonadota
Pleurocapsa	Cyanophyceae	Cyanobacteriota
Nodosilinea	Cyanophyceae	Cyanobacteriota
Coleofasciculus	Cyanophyceae	Cyanobacteriota
Modestobacter	Actinomycetes	Actinomycetota
Saccharopolyspora	Actinomycetes	Actinomycetota
Myroides	Flavobacteriia	Bacteroidota
Gloeobacter	Cyanophyceae	Cyanobacteriota
Pseudobdellovibrio	Bdellovibrionia	Bdellovibrionota
Vallitalea	Clostridia	Bacillota
Mycobacteroides	Actinomycetes	Actinomycetota
Desulfatitalea	Desulfobacteria	Thermodesulfobacteriota
Desertifilum	Cyanophyceae	Cyanobacteriota
Rhodovulum	Alphaproteobacteria	Pseudomonadota
Mariprofundus	Zetaproteobacteria	Pseudomonadota
Ferriphaselus	Betaproteobacteria	Pseudomonadota
Paraburkholderia	Betaproteobacteria	Pseudomonadota
Corallococcus	Myxococcia	Myxococcota
NA	Alphaproteobacteria	Pseudomonadota
Filomicrobium	Alphaproteobacteria	Pseudomonadota
NA	Betaproteobacteria	Pseudomonadota
Calidifontibacillus	Bacilli	Bacillota
Chondromyces	NA	Myxococcota
Vogesella	Betaproteobacteria	Pseudomonadota
Granulosicoccus	Gammaproteobacteria	Pseudomonadota
Roseibacterium	Alphaproteobacteria	Pseudomonadota
Tetrasphaera	Actinomycetes	Actinomycetota
Gilliamella	Gammaproteobacteria	Pseudomonadota
Snodgrassella	Betaproteobacteria	Pseudomonadota
Niveibacterium	Betaproteobacteria	Pseudomonadota
Rhodobaca	Alphaproteobacteria	Pseudomonadota
Rubrivirga	Rhodothermia	Rhodothermota
Nannocystis	NA	Myxococcota
Chromohalobacter	Gammaproteobacteria	Pseudomonadota
Acidithiobacillus	Acidithiobacillia	Pseudomonadota
Falsiruegeria	Alphaproteobacteria	Pseudomonadota
Subtercola	Actinomycetes	Actinomycetota
Paenalcaligenes	Betaproteobacteria	Pseudomonadota
Litorilinea	Caldilineae	Chloroflexota
Phocaeicola	Bacteroidia	Bacteroidota
Reyranella	Alphaproteobacteria	Pseudomonadota
Jatrophihabitans	Actinomycetes	Actinomycetota
Puniceibacterium	Alphaproteobacteria	Pseudomonadota
Hyphomonas	Alphaproteobacteria	Pseudomonadota
Piscicoccus	Actinomycetes	Actinomycetota
Celeribacter	Alphaproteobacteria	Pseudomonadota
Photorhabdus	Gammaproteobacteria	Pseudomonadota
Roseiflexus	Chloroflexia	Chloroflexota
NA	NA	Planctomycetota
Ferrimicrobium	Acidimicrobiia	Actinomycetota
Legionella	Gammaproteobacteria	Pseudomonadota
Pseudarthrobacter	Actinomycetes	Actinomycetota
Actinocrispum	Actinomycetes	Actinomycetota
Sinirhodobacter	Alphaproteobacteria	Pseudomonadota
Echinimonas	Gammaproteobacteria	Pseudomonadota
Virgibacillus	Bacilli	Bacillota
Nguyenibacter	Alphaproteobacteria	Pseudomonadota
Pannonibacter	Alphaproteobacteria	Pseudomonadota
Halioglobus	Gammaproteobacteria	Pseudomonadota
Dyella	Gammaproteobacteria	Pseudomonadota
Dehalogenimonas	Dehalococcoidia	Chloroflexota
Vannielia	Alphaproteobacteria	Pseudomonadota
Kordia	Flavobacteriia	Bacteroidota
Caenibius	Alphaproteobacteria	Pseudomonadota
Millisia	Actinomycetes	Actinomycetota
Flavihumibacter	Chitinophagia	Bacteroidota
Fictibacillus	Bacilli	Bacillota
Psychrobacillus	Bacilli	Bacillota
Pectobacterium	Gammaproteobacteria	Pseudomonadota
Sanguibacter	Actinomycetes	Actinomycetota
Kribbia	Actinomycetes	Actinomycetota
Sulfuritalea	Betaproteobacteria	Pseudomonadota
NA	NA	Pseudomonadota
Noviherbaspirillum	Betaproteobacteria	Pseudomonadota
Pseudoroseomonas	Alphaproteobacteria	Pseudomonadota
Sediminicoccus	Alphaproteobacteria	Pseudomonadota
Thalassobacillus	Bacilli	Bacillota
Rickettsiella	Gammaproteobacteria	Pseudomonadota
Loktanella	Alphaproteobacteria	Pseudomonadota
Membranihabitans	Saprospiria	Bacteroidota
Sphingomicrobium	Alphaproteobacteria	Pseudomonadota
Glaciimonas	Betaproteobacteria	Pseudomonadota
Salimicrobium	Bacilli	Bacillota
Hydrogenophaga	Betaproteobacteria	Pseudomonadota
Nitrosospira	Betaproteobacteria	Pseudomonadota
Acidisphaera	Alphaproteobacteria	Pseudomonadota
Oceaniovalibus	Alphaproteobacteria	Pseudomonadota
Tanticharoenia	Alphaproteobacteria	Pseudomonadota
Cardinium	Cytophagia	Bacteroidota
Desulfuromonas	Desulfuromonadia	Thermodesulfobacteriota
Pseudorhizobium	Alphaproteobacteria	Pseudomonadota
Ideonella	Betaproteobacteria	Pseudomonadota
Nitrospira	Nitrospiria	Nitrospirota
Komagataeibacter	Alphaproteobacteria	Pseudomonadota
Mucilaginibacter	Sphingobacteriia	Bacteroidota
Nocardiopsis	Actinomycetes	Actinomycetota
Pseudorhodoplanes	Alphaproteobacteria	Pseudomonadota
Oscillibacter	Clostridia	Bacillota
Hydrobacter	Chitinophagia	Bacteroidota
Mesotoga	Thermotogae	Thermotogota
Methylobacillus	Betaproteobacteria	Pseudomonadota
Iodidimonas	Alphaproteobacteria	Pseudomonadota
Halalkalibacter	Bacilli	Bacillota
Piscirickettsia	Gammaproteobacteria	Pseudomonadota
Caenispirillum	Alphaproteobacteria	Pseudomonadota
NA	NA	Bacillota
Sodalis	Gammaproteobacteria	Pseudomonadota
Mariniradius	Cytophagia	Bacteroidota
Blastopirellula	Planctomycetia	Planctomycetota
Cystobacter	Myxococcia	Myxococcota
Leuconostoc	Bacilli	Bacillota
Scytonema	Cyanophyceae	Cyanobacteriota
Desulfamplus	Desulfobacteria	Thermodesulfobacteriota
Verticiella	Betaproteobacteria	Pseudomonadota
Leucothrix	Gammaproteobacteria	Pseudomonadota
Pseudooceanicola	Alphaproteobacteria	Pseudomonadota
Blastomonas	Alphaproteobacteria	Pseudomonadota
Porphyrobacter	Alphaproteobacteria	Pseudomonadota
Bacterioplanes	Gammaproteobacteria	Pseudomonadota
Imhoffiella	Gammaproteobacteria	Pseudomonadota
Gillisia	Flavobacteriia	Bacteroidota
Psychroserpens	Flavobacteriia	Bacteroidota
Salipiger	Alphaproteobacteria	Pseudomonadota
Roseomonas	Alphaproteobacteria	Pseudomonadota
Ornithinimicrobium	Actinomycetes	Actinomycetota
Sorangium	NA	Myxococcota
Pediococcus	Bacilli	Bacillota
Lederbergia	Bacilli	Bacillota
Peptostreptococcus	Clostridia	Bacillota
Pseudacidovorax	Betaproteobacteria	Pseudomonadota
Cellulomonas	Actinomycetes	Actinomycetota
Geobacter	Desulfuromonadia	Thermodesulfobacteriota
Citrobacter	Gammaproteobacteria	Pseudomonadota
Mangrovibacterium	Bacteroidia	Bacteroidota
Aromatoleum	Betaproteobacteria	Pseudomonadota
Anaerostipes	Clostridia	Bacillota
Tamaricihabitans	Actinomycetes	Actinomycetota
Dialister	Negativicutes	Bacillota
Odoribacter	Bacteroidia	Bacteroidota
Phormidium	Cyanophyceae	Cyanobacteriota
Zavarzinia	Alphaproteobacteria	Pseudomonadota
Pseudohaliea	Gammaproteobacteria	Pseudomonadota
Caldimonas	Betaproteobacteria	Pseudomonadota
Colwellia	Gammaproteobacteria	Pseudomonadota
Curvibacter	Betaproteobacteria	Pseudomonadota
Rhodopirellula	Planctomycetia	Planctomycetota
Brochothrix	Bacilli	Bacillota
Glaciihabitans	Actinomycetes	Actinomycetota
Salinicola	Gammaproteobacteria	Pseudomonadota
Croceibacterium	Alphaproteobacteria	Pseudomonadota
Brevirhabdus	Alphaproteobacteria	Pseudomonadota
NA	Actinomycetes	Actinomycetota
Frondihabitans	Actinomycetes	Actinomycetota
Galbitalea	Actinomycetes	Actinomycetota
Diaminobutyricibacter	Actinomycetes	Actinomycetota
Taibaiella	Chitinophagia	Bacteroidota
Micrococcus	Actinomycetes	Actinomycetota
Thiohalobacter	Gammaproteobacteria	Pseudomonadota
Dermacoccus	Actinomycetes	Actinomycetota
Enterobacter	Gammaproteobacteria	Pseudomonadota
Thiobaca	Gammaproteobacteria	Pseudomonadota
Caldibacillus	Bacilli	Bacillota
Paeniglutamicibacter	Actinomycetes	Actinomycetota
Staphylococcus	Bacilli	Bacillota
Myxococcus	Myxococcia	Myxococcota
Psychromonas	Gammaproteobacteria	Pseudomonadota
Oceanimonas	Gammaproteobacteria	Pseudomonadota
Novispirillum	Alphaproteobacteria	Pseudomonadota
Butyrivibrio	Clostridia	Bacillota
Enterocloster	Clostridia	Bacillota
Aliiruegeria	Alphaproteobacteria	Pseudomonadota
Shimia	Alphaproteobacteria	Pseudomonadota
Acidiferrobacter	Gammaproteobacteria	Pseudomonadota
Uruburuella	Betaproteobacteria	Pseudomonadota
Conexibacter	Thermoleophilia	Actinomycetota
Methylohalobius	Gammaproteobacteria	Pseudomonadota
Paramagnetospirillum	Alphaproteobacteria	Pseudomonadota
Tessaracoccus	Actinomycetes	Actinomycetota
Pandoraea	Betaproteobacteria	Pseudomonadota
Methylophaga	Gammaproteobacteria	Pseudomonadota
Peptoclostridium	Clostridia	Bacillota
Crassaminicella	Clostridia	Bacillota
Robertmurraya	Bacilli	Bacillota
Nioella	Alphaproteobacteria	Pseudomonadota
Anaerococcus	Tissierellia	Bacillota
Diaphorobacter	Betaproteobacteria	Pseudomonadota
Magnetospira	Alphaproteobacteria	Pseudomonadota
Paenarthrobacter	Actinomycetes	Actinomycetota
Geobacillus	Bacilli	Bacillota
Swingsia	Alphaproteobacteria	Pseudomonadota
Aquitalea	Betaproteobacteria	Pseudomonadota
Xanthomonas	Gammaproteobacteria	Pseudomonadota
Desulfosarcina	Desulfobacteria	Thermodesulfobacteriota
Rhodothermus	Rhodothermia	Rhodothermota
Croceicoccus	Alphaproteobacteria	Pseudomonadota
Methylogaea	Gammaproteobacteria	Pseudomonadota
Photobacterium	Gammaproteobacteria	Pseudomonadota
Larsenimonas	Gammaproteobacteria	Pseudomonadota
Azoarcus	Betaproteobacteria	Pseudomonadota
Merismopedia	Cyanophyceae	Cyanobacteriota
Aquimarina	Flavobacteriia	Bacteroidota
Paucilactobacillus	Bacilli	Bacillota
Aquabacterium	Betaproteobacteria	Pseudomonadota
Anaerobacterium	Clostridia	Bacillota
Cyanobium	Cyanophyceae	Cyanobacteriota
Intestinimonas	Clostridia	Bacillota
Algimonas	Alphaproteobacteria	Pseudomonadota
Solirubrobacter	Thermoleophilia	Actinomycetota
Marmoricola	Actinomycetes	Actinomycetota
Mesobacillus	Bacilli	Bacillota
Dokdonella	Gammaproteobacteria	Pseudomonadota
Isoptericola	Actinomycetes	Actinomycetota
Anaeromyxobacter	Myxococcia	Myxococcota
Cnuella	Chitinophagia	Bacteroidota
Dactylococcopsis	Cyanophyceae	Cyanobacteriota
Caldisalinibacter	Tissierellia	Bacillota
Hassalia	Cyanophyceae	Cyanobacteriota
Dechloromonas	Betaproteobacteria	Pseudomonadota
Desulfitibacter	Clostridia	Bacillota
Citrifermentans	Desulfuromonadia	Thermodesulfobacteriota
Parapedobacter	Sphingobacteriia	Bacteroidota
Salinispora	Actinomycetes	Actinomycetota
Protofrankia	Actinomycetes	Actinomycetota
Kiritimatiella	Kiritimatiellia	Kiritimatiellota
Sedimentibacter	Tissierellia	Bacillota
Crossiella	Actinomycetes	Actinomycetota
Limnobacter	Betaproteobacteria	Pseudomonadota
Actinomyces	Actinomycetes	Actinomycetota
Williamsia	Actinomycetes	Actinomycetota
Ilumatobacter	Acidimicrobiia	Actinomycetota
Phaeobacter	Alphaproteobacteria	Pseudomonadota
Oceanicola	Alphaproteobacteria	Pseudomonadota
Oceanococcus	Gammaproteobacteria	Pseudomonadota
Pseudaestuariivita	Alphaproteobacteria	Pseudomonadota
Tistlia	Alphaproteobacteria	Pseudomonadota
Prescottella	Actinomycetes	Actinomycetota
Streptomonospora	Actinomycetes	Actinomycetota
Roseibium	Alphaproteobacteria	Pseudomonadota
Nitrospina	Nitrospinia	Nitrospinota
Muriicola	Flavobacteriia	Bacteroidota
Limisphaera	Verrucomicrobiae	Verrucomicrobiota
Aquisalimonas	Gammaproteobacteria	Pseudomonadota
Azotobacter	Gammaproteobacteria	Pseudomonadota
Desertibacillus	Bacilli	Bacillota
Acetobacterium	Clostridia	Bacillota
Arenicella	Gammaproteobacteria	Pseudomonadota
Lelliottia	Gammaproteobacteria	Pseudomonadota
Kosakonia	Gammaproteobacteria	Pseudomonadota
Thermogutta	Planctomycetia	Planctomycetota
Serratia	Gammaproteobacteria	Pseudomonadota
Variibacter	Alphaproteobacteria	Pseudomonadota
Tepidicaulis	Alphaproteobacteria	Pseudomonadota
Paradevosia	Alphaproteobacteria	Pseudomonadota
Gordonibacter	Coriobacteriia	Actinomycetota
Spiribacter	Gammaproteobacteria	Pseudomonadota
Carnimonas	Gammaproteobacteria	Pseudomonadota
Roseateles	Betaproteobacteria	Pseudomonadota
Formosa	Flavobacteriia	Bacteroidota
Nitrosomonas	Betaproteobacteria	Pseudomonadota
Sinomonas	Actinomycetes	Actinomycetota
Methylicorpusculum	Gammaproteobacteria	Pseudomonadota
Enterovirga	Alphaproteobacteria	Pseudomonadota
Olsenella	Coriobacteriia	Actinomycetota
Bryobacter	Terriglobia	Acidobacteriota
Rehaibacterium	Gammaproteobacteria	Pseudomonadota
Sulfitobacter	Alphaproteobacteria	Pseudomonadota
Sphingorhabdus	Alphaproteobacteria	Pseudomonadota
NA	Verrucomicrobiae	Verrucomicrobiota
NA	Opitutae	Verrucomicrobiota
Anaerosalibacter	Tissierellia	Bacillota
Naumannella	Actinomycetes	Actinomycetota
Priestia	Bacilli	Bacillota
Candidatus Similichlamydia	Chlamydiia	Chlamydiota
Chelatococcus	Alphaproteobacteria	Pseudomonadota
Cryptosporangium	Actinomycetes	Actinomycetota
Roseimicrobium	Verrucomicrobiae	Verrucomicrobiota
Mumia	Actinomycetes	Actinomycetota
Coprobacter	Bacteroidia	Bacteroidota
Enterococcus	Bacilli	Bacillota
Allosalinactinospora	Actinomycetes	Actinomycetota
Thioclava	Alphaproteobacteria	Pseudomonadota
Xenorhabdus	Gammaproteobacteria	Pseudomonadota
Helicobacter	Epsilonproteobacteria	Campylobacterota
Idiomarina	Gammaproteobacteria	Pseudomonadota
Lactococcus	Bacilli	Bacillota
Sinorhizobium	Alphaproteobacteria	Pseudomonadota
NA	Spirochaetia	Spirochaetota
Globicatella	Bacilli	Bacillota
Knoellia	Actinomycetes	Actinomycetota
Kibdelosporangium	Actinomycetes	Actinomycetota
Consotaella	Alphaproteobacteria	Pseudomonadota
Sinosporangium	Actinomycetes	Actinomycetota
Romboutsia	Clostridia	Bacillota
Allorhizobium	Alphaproteobacteria	Pseudomonadota
Marinococcus	Bacilli	Bacillota
Planococcus	Bacilli	Bacillota
Thiocystis	Gammaproteobacteria	Pseudomonadota
Asanoa	Actinomycetes	Actinomycetota
Thalassomonas	Gammaproteobacteria	Pseudomonadota
Granulicatella	Bacilli	Bacillota
Chroococcidiopsis	Cyanophyceae	Cyanobacteriota
Nodularia	Cyanophyceae	Cyanobacteriota
Gemella	Bacilli	Bacillota
Gemmatimonas	Gemmatimonadetes	Gemmatimonadota
Roseivivax	Alphaproteobacteria	Pseudomonadota
Rufibacter	Cytophagia	Bacteroidota
Terrilactibacillus	Bacilli	Bacillota
Haloimpatiens	Clostridia	Bacillota
Pseudidiomarina	Gammaproteobacteria	Pseudomonadota
Aliihoeflea	Alphaproteobacteria	Pseudomonadota
Quatrionicoccus	Betaproteobacteria	Pseudomonadota
Sulfurisoma	Betaproteobacteria	Pseudomonadota
Thermorudis	Thermomicrobia	Thermomicrobiota
Aequorivita	Flavobacteriia	Bacteroidota
Glycocaulis	Alphaproteobacteria	Pseudomonadota
Methyloceanibacter	Alphaproteobacteria	Pseudomonadota
NA	Bacilli	Bacillota
Curtobacterium	Actinomycetes	Actinomycetota
Skermanella	Alphaproteobacteria	Pseudomonadota
Pontibacillus	Bacilli	Bacillota
Thiohalocapsa	Gammaproteobacteria	Pseudomonadota
Algisphaera	Phycisphaerae	Planctomycetota
Intrasporangium	Actinomycetes	Actinomycetota
Schmidhempelia	Gammaproteobacteria	Pseudomonadota
Primorskyibacter	Alphaproteobacteria	Pseudomonadota
Paludisphaera	Planctomycetia	Planctomycetota
Vulgatibacter	Myxococcia	Myxococcota
Labilithrix	NA	Myxococcota
Rubrobacter	Rubrobacteria	Actinomycetota
Rhizocola	Actinomycetes	Actinomycetota
Denitromonas	Betaproteobacteria	Pseudomonadota
NA	NA	Candidatus Absconditabacteria
Tardiphaga	Alphaproteobacteria	Pseudomonadota
Haloferula	Verrucomicrobiae	Verrucomicrobiota
Leisingera	Alphaproteobacteria	Pseudomonadota
Roseospira	Alphaproteobacteria	Pseudomonadota
Contendobacter	Gammaproteobacteria	Pseudomonadota
Competibacter	Gammaproteobacteria	Pseudomonadota
Clavibacter	Actinomycetes	Actinomycetota
Pseudosulfitobacter	Alphaproteobacteria	Pseudomonadota
Trichococcus	Bacilli	Bacillota
Peribacillus	Bacilli	Bacillota
Mesomycoplasma	NA	Mycoplasmatota
Lacrimispora	Clostridia	Bacillota
Orenia	Clostridia	Bacillota
Tepidibacillus	Bacilli	Bacillota
Oleiphilus	Gammaproteobacteria	Pseudomonadota
Oceanisphaera	Gammaproteobacteria	Pseudomonadota
Protochlamydia	Chlamydiia	Chlamydiota
Nucleicultrix	Alphaproteobacteria	Pseudomonadota
Polycyclovorans	Gammaproteobacteria	Pseudomonadota
Algiphilus	Gammaproteobacteria	Pseudomonadota
Anaerosolibacter	Clostridia	Bacillota
Sneathiella	Alphaproteobacteria	Pseudomonadota
Thermomonas	Gammaproteobacteria	Pseudomonadota
Methyloprofundus	Gammaproteobacteria	Pseudomonadota
Kurthia	Bacilli	Bacillota
Lacticaseibacillus	Bacilli	Bacillota
Geosporobacter	Clostridia	Bacillota
Prauserella	Actinomycetes	Actinomycetota
Mangrovactinospora	Actinomycetes	Actinomycetota
Dethiosulfatarculus	Desulfarculia	Thermodesulfobacteriota
Oricola	Alphaproteobacteria	Pseudomonadota
Atopomonas	Gammaproteobacteria	Pseudomonadota
Methylocaldum	Gammaproteobacteria	Pseudomonadota
Actibacterium	Alphaproteobacteria	Pseudomonadota
Domibacillus	Bacilli	Bacillota
Mameliella	Alphaproteobacteria	Pseudomonadota
Motilibacter	Actinomycetes	Actinomycetota
Magnetofaba	Alphaproteobacteria	Pseudomonadota
Fluviicoccus	Gammaproteobacteria	Pseudomonadota
Actinacidiphila	Actinomycetes	Actinomycetota
Chenggangzhangella	Alphaproteobacteria	Pseudomonadota
Pullulanibacillus	Bacilli	Bacillota
Criblamydia	Chlamydiia	Chlamydiota
Methylobrevis	Alphaproteobacteria	Pseudomonadota
Maricaulis	Alphaproteobacteria	Pseudomonadota
Luteibacter	Gammaproteobacteria	Pseudomonadota
Chryseomicrobium	Bacilli	Bacillota
Sphaerisporangium	Actinomycetes	Actinomycetota
Dankookia	Alphaproteobacteria	Pseudomonadota
Acuticoccus	Alphaproteobacteria	Pseudomonadota
Kitasatospora	Actinomycetes	Actinomycetota
Phenylobacterium	Alphaproteobacteria	Pseudomonadota
Gynuella	Gammaproteobacteria	Pseudomonadota
Lutimonas	Flavobacteriia	Bacteroidota
Youhaiella	Alphaproteobacteria	Pseudomonadota
Wenxinia	Alphaproteobacteria	Pseudomonadota
Candidatus Fervidibacter	NA	Candidatus Fervidibacteria
Crenobacter	Betaproteobacteria	Pseudomonadota
Tahibacter	Gammaproteobacteria	Pseudomonadota
Magnetobacterium	Nitrospiria	Nitrospirota
Hylemonella	Betaproteobacteria	Pseudomonadota
Serpentinimonas	Betaproteobacteria	Pseudomonadota
Phaeomarinobacter	Alphaproteobacteria	Pseudomonadota
Okeania	Cyanophyceae	Cyanobacteriota
Sporosarcina	Bacilli	Bacillota
Microbispora	Actinomycetes	Actinomycetota
Aestuariispira	Alphaproteobacteria	Pseudomonadota
Mobilitalea	Clostridia	Bacillota
Klebsiella	Gammaproteobacteria	Pseudomonadota
Qipengyuania	Alphaproteobacteria	Pseudomonadota
Bifidobacterium	Actinomycetes	Actinomycetota
Sporolactobacillus	Bacilli	Bacillota
Oceanobacillus	Bacilli	Bacillota
Motiliproteus	Gammaproteobacteria	Pseudomonadota
Delftia	Betaproteobacteria	Pseudomonadota
Carbonactinospora	Actinomycetes	Actinomycetota
Salinibacter	Rhodothermia	Rhodothermota
Azospira	Betaproteobacteria	Pseudomonadota
Kineothrix	Clostridia	Bacillota
Aestuariicella	Gammaproteobacteria	Pseudomonadota
Zhongshania	Gammaproteobacteria	Pseudomonadota
Humidesulfovibrio	Desulfovibrionia	Thermodesulfobacteriota
Aestuariivita	Alphaproteobacteria	Pseudomonadota
NA	Bacteroidia	Bacteroidota
Belliella	Cytophagia	Bacteroidota
Enorma	Coriobacteriia	Actinomycetota
Petrotoga	Thermotogae	Thermotogota
Litoribrevibacter	Gammaproteobacteria	Pseudomonadota
Roseiarcus	Alphaproteobacteria	Pseudomonadota
Paludibaculum	Terriglobia	Acidobacteriota
Mizugakiibacter	Gammaproteobacteria	Pseudomonadota
Heyndrickxia	Bacilli	Bacillota
Hafnia	Gammaproteobacteria	Pseudomonadota
Hartmannibacter	Alphaproteobacteria	Pseudomonadota
Alcaligenes	Betaproteobacteria	Pseudomonadota
Tamilnaduibacter	Gammaproteobacteria	Pseudomonadota
Lichenicola	Alphaproteobacteria	Pseudomonadota
Rhodoferax	Betaproteobacteria	Pseudomonadota
Cecembia	Cytophagia	Bacteroidota
Crenalkalicoccus	Alphaproteobacteria	Pseudomonadota
Enterobacillus	Gammaproteobacteria	Pseudomonadota
Actinoallomurus	Actinomycetes	Actinomycetota
Paramesorhizobium	Alphaproteobacteria	Pseudomonadota
Sporohalobacter	Clostridia	Bacillota
Listeria	Bacilli	Bacillota
Thermopetrobacter	Alphaproteobacteria	Pseudomonadota
Methyloterricola	Gammaproteobacteria	Pseudomonadota
Salmonella	Gammaproteobacteria	Pseudomonadota
Clostridioides	Clostridia	Bacillota
Stackebrandtia	Actinomycetes	Actinomycetota
Neosynechococcus	Cyanophyceae	Cyanobacteriota
NA	Thermoleophilia	Actinomycetota
Hathewaya	Clostridia	Bacillota
Finegoldia	Tissierellia	Bacillota
Rhizobacter	Betaproteobacteria	Pseudomonadota
Halopolyspora	Actinomycetes	Actinomycetota
Palleronia	Alphaproteobacteria	Pseudomonadota
Thiopseudomonas	Gammaproteobacteria	Pseudomonadota
Kamptonema	Cyanophyceae	Cyanobacteriota
Alsobacter	Alphaproteobacteria	Pseudomonadota
Anoxybacillus	Bacilli	Bacillota
Evansella	Bacilli	Bacillota
Alteraurantiacibacter	Alphaproteobacteria	Pseudomonadota
Pseudocitrobacter	Gammaproteobacteria	Pseudomonadota
Emcibacter	Alphaproteobacteria	Pseudomonadota
Convivina	Bacilli	Bacillota
Dakarella	Betaproteobacteria	Pseudomonadota
Iodobacter	Betaproteobacteria	Pseudomonadota
Desulfoprunum	Desulfobulbia	Thermodesulfobacteriota
Cognatiyoonia	Alphaproteobacteria	Pseudomonadota
Aureibacillus	Bacilli	Bacillota
Plastoroseomonas	Alphaproteobacteria	Pseudomonadota
Thermoclostridium	Clostridia	Bacillota
Permianibacter	Gammaproteobacteria	Pseudomonadota
Ascidiaceihabitans	Alphaproteobacteria	Pseudomonadota
Rahnella	Gammaproteobacteria	Pseudomonadota
Desulfocurvibacter	Desulfovibrionia	Thermodesulfobacteriota
Aquisphaera	Planctomycetia	Planctomycetota
Rouxiella	Gammaproteobacteria	Pseudomonadota
Neolewinella	Saprospiria	Bacteroidota
Amphiplicatus	Alphaproteobacteria	Pseudomonadota
Starkeya	Alphaproteobacteria	Pseudomonadota
Chloroflexus	Chloroflexia	Chloroflexota
Aurantimonas	Alphaproteobacteria	Pseudomonadota
Numidum	Bacilli	Bacillota
Nigerium	Actinomycetes	Actinomycetota
Metabacillus	Bacilli	Bacillota
Labedella	Actinomycetes	Actinomycetota
Jiangella	Actinomycetes	Actinomycetota
Pseudohongiella	Gammaproteobacteria	Pseudomonadota
Litorivivens	Gammaproteobacteria	Pseudomonadota
Pseudactinotalea	Actinomycetes	Actinomycetota
Moorella	Clostridia	Bacillota
NA	NA	Bacteroidota
Alkalimonas	Gammaproteobacteria	Pseudomonadota
Sinisalibacter	Alphaproteobacteria	Pseudomonadota
Lacimicrobium	Gammaproteobacteria	Pseudomonadota
Aquisalinus	Alphaproteobacteria	Pseudomonadota
Chitinibacter	Betaproteobacteria	Pseudomonadota
Oryzisolibacter	Betaproteobacteria	Pseudomonadota
Hydromonas	Betaproteobacteria	Pseudomonadota
Mangrovibacter	Gammaproteobacteria	Pseudomonadota
Oceanicaulis	Alphaproteobacteria	Pseudomonadota
Kozakia	Alphaproteobacteria	Pseudomonadota
Sporocytophaga	Cytophagia	Bacteroidota
Emticicia	Cytophagia	Bacteroidota
Thiogranum	Gammaproteobacteria	Pseudomonadota
Pseudochelatococcus	Alphaproteobacteria	Pseudomonadota
Aeromicrobium	Actinomycetes	Actinomycetota
Alteriqipengyuania	Alphaproteobacteria	Pseudomonadota
Dinghuibacter	Chitinophagia	Bacteroidota
Bombella	Alphaproteobacteria	Pseudomonadota
Halotia	Cyanophyceae	Cyanobacteriota
Spirochaeta	Spirochaetia	Spirochaetota
Prolixibacter	Bacteroidia	Bacteroidota
Georgenia	Actinomycetes	Actinomycetota
NA	Candidatus Izimaplasma	Mycoplasmatota
Oleiagrimonas	Gammaproteobacteria	Pseudomonadota
Nitrospirillum	Alphaproteobacteria	Pseudomonadota
Plantactinospora	Actinomycetes	Actinomycetota
Nitrincola	Gammaproteobacteria	Pseudomonadota
Cephaloticoccus	Opitutae	Verrucomicrobiota
Aureibaculum	Flavobacteriia	Bacteroidota
Woeseia	Gammaproteobacteria	Pseudomonadota
Oceanicella	Alphaproteobacteria	Pseudomonadota
Quisquiliibacterium	Betaproteobacteria	Pseudomonadota
Sapientia	Betaproteobacteria	Pseudomonadota
Siculibacillus	Alphaproteobacteria	Pseudomonadota
Kiloniella	Alphaproteobacteria	Pseudomonadota
Thermoanaerobacterium	Clostridia	Bacillota
Aetokthonos	Cyanophyceae	Cyanobacteriota
Aquisediminimonas	Alphaproteobacteria	Pseudomonadota
Corticibacter	Betaproteobacteria	Pseudomonadota
Fulvimonas	Gammaproteobacteria	Pseudomonadota
Zoogloea	Betaproteobacteria	Pseudomonadota
Mycoavidus	Betaproteobacteria	Pseudomonadota
Falsigemmobacter	Alphaproteobacteria	Pseudomonadota
Gallibacterium	Gammaproteobacteria	Pseudomonadota
Sulfuriferula	Betaproteobacteria	Pseudomonadota
Silvibacterium	Terriglobia	Acidobacteriota
Labrenzia	Alphaproteobacteria	Pseudomonadota
Microbulbifer	Gammaproteobacteria	Pseudomonadota
Desulfurella	Desulfurellia	Campylobacterota
Herbinix	Clostridia	Bacillota
Gracilibacillus	Bacilli	Bacillota
Limoniibacter	Alphaproteobacteria	Pseudomonadota
Rugosibacter	Betaproteobacteria	Pseudomonadota
NA	NA	Verrucomicrobiota
Cedecea	Gammaproteobacteria	Pseudomonadota
Magnetococcus	Alphaproteobacteria	Pseudomonadota
Boudabousia	Actinomycetes	Actinomycetota
Seohaeicola	Alphaproteobacteria	Pseudomonadota
Dysgonomonas	Bacteroidia	Bacteroidota
Treponema	Spirochaetia	Spirochaetota
Thioflexithrix	Gammaproteobacteria	Pseudomonadota
NA	Clostridia	Bacillota
Xylanibacillus	Bacilli	Bacillota
Gellertiella	Alphaproteobacteria	Pseudomonadota
Lyngbya	Cyanophyceae	Cyanobacteriota
Sterolibacterium	Betaproteobacteria	Pseudomonadota
Planctomicrobium	Planctomycetia	Planctomycetota
NA	NA	candidate division WWE3
Terracidiphilus	Terriglobia	Acidobacteriota
Phaeocystidibacter	Flavobacteriia	Bacteroidota
Lactobacillus	Bacilli	Bacillota
Cellulosimicrobium	Actinomycetes	Actinomycetota
Methylopumilus	Betaproteobacteria	Pseudomonadota
Sphaerochaeta	Spirochaetia	Spirochaetota
Leminorella	Gammaproteobacteria	Pseudomonadota
Megamonas	Negativicutes	Bacillota
Yokenella	Gammaproteobacteria	Pseudomonadota
Lactiplantibacillus	Bacilli	Bacillota
Desulfonatronum	Desulfovibrionia	Thermodesulfobacteriota
Ligilactobacillus	Bacilli	Bacillota
Anaerotignum	Clostridia	Bacillota
Samsonia	Gammaproteobacteria	Pseudomonadota
Acidihalobacter	Gammaproteobacteria	Pseudomonadota
Raoultella	Gammaproteobacteria	Pseudomonadota
Tianweitania	Alphaproteobacteria	Pseudomonadota
Henriciella	Alphaproteobacteria	Pseudomonadota
Euzebya	Nitriliruptoria	Actinomycetota
Hydrogenibacillus	Bacilli	Bacillota
Halofilum	Gammaproteobacteria	Pseudomonadota
Thermodesulfobacterium	Thermodesulfobacteria	Thermodesulfobacteriota
Niveispirillum	Alphaproteobacteria	Pseudomonadota
Methylocapsa	Alphaproteobacteria	Pseudomonadota
Pararhizobium	Alphaproteobacteria	Pseudomonadota
Planomonospora	Actinomycetes	Actinomycetota
Mixta	Gammaproteobacteria	Pseudomonadota
Acidicapsa	Terriglobia	Acidobacteriota
Catellatospora	Actinomycetes	Actinomycetota
Geminocystis	Cyanophyceae	Cyanobacteriota
NA	NA	Candidatus Berkelbacteria
NA	NA	Candidatus Wolfebacteria
Duffyella	Gammaproteobacteria	Pseudomonadota
Sulfuricaulis	Gammaproteobacteria	Pseudomonadota
Haliangium	NA	Myxococcota
Paraglaciecola	Gammaproteobacteria	Pseudomonadota
Desulfofervidus	Candidatus Desulfofervidia	Thermodesulfobacteriota
Peptoniphilus	Tissierellia	Bacillota
Gemmiger	Clostridia	Bacillota
Oerskovia	Actinomycetes	Actinomycetota
Carboxylicivirga	Bacteroidia	Bacteroidota
Mariniphaga	Bacteroidia	Bacteroidota
Hahella	Gammaproteobacteria	Pseudomonadota
Specibacter	Actinomycetes	Actinomycetota
Rubeoparvulum	Bacilli	Bacillota
Luteipulveratus	Actinomycetes	Actinomycetota
Brevibacterium	Actinomycetes	Actinomycetota
Hydrogenobacter	Aquificae	Aquificota
Planctomyces	Planctomycetia	Planctomycetota
Methylocucumis	Gammaproteobacteria	Pseudomonadota
Thalassobaculum	Alphaproteobacteria	Pseudomonadota
Pokkaliibacter	Gammaproteobacteria	Pseudomonadota
Mycoplana	Alphaproteobacteria	Pseudomonadota
Limnoraphis	Cyanophyceae	Cyanobacteriota
Cytobacillus	Bacilli	Bacillota
Anabaena	Cyanophyceae	Cyanobacteriota
Aliiroseovarius	Alphaproteobacteria	Pseudomonadota
Longimicrobium	Longimicrobiia	Gemmatimonadota
Lysinibacter	Actinomycetes	Actinomycetota
Williamwhitmania	Bacteroidia	Bacteroidota
Sinobacterium	Gammaproteobacteria	Pseudomonadota
Beijerinckia	Alphaproteobacteria	Pseudomonadota
Granulicella	Terriglobia	Acidobacteriota
Phytoactinopolyspora	Actinomycetes	Actinomycetota
Kryptobacter	NA	Candidatus Kryptonia
NA	Coriobacteriia	Actinomycetota
Ammoniphilus	Bacilli	Bacillota
NA	Ignavibacteria	Ignavibacteriota
Renibacterium	Actinomycetes	Actinomycetota
Pseudovibrio	Alphaproteobacteria	Pseudomonadota
Erysipelothrix	Erysipelotrichia	Bacillota
Gimesia	Planctomycetia	Planctomycetota
Shouchella	Bacilli	Bacillota
Desnuesiella	Clostridia	Bacillota
Neptunochlamydia	Chlamydiia	Chlamydiota
Segatella	Bacteroidia	Bacteroidota
Halobacteriovorax	Bacteriovoracia	Bdellovibrionota
Lentzea	Actinomycetes	Actinomycetota
Alloactinosynnema	Actinomycetes	Actinomycetota
Blattabacterium	Flavobacteriia	Bacteroidota
Thiospirillum	Gammaproteobacteria	Pseudomonadota
Umezawaea	Actinomycetes	Actinomycetota
Thiodiazotropha	Gammaproteobacteria	Pseudomonadota
Serinibacter	Actinomycetes	Actinomycetota
Rubritalea	Verrucomicrobiae	Verrucomicrobiota
Leekyejoonella	Actinomycetes	Actinomycetota
Kordiimonas	Alphaproteobacteria	Pseudomonadota
Caminicella	Clostridia	Bacillota
NA	NA	Chloroflexota
NA	NA	Nitrospirota
NA	Deltaproteobacteria	NA
Nitratireductor	Alphaproteobacteria	Pseudomonadota
Aquibium	Alphaproteobacteria	Pseudomonadota
Egicoccus	Nitriliruptoria	Actinomycetota
Egibacter	Nitriliruptoria	Actinomycetota
Acidiphilium	Alphaproteobacteria	Pseudomonadota
Xaviernesmea	Alphaproteobacteria	Pseudomonadota
Maliponia	Alphaproteobacteria	Pseudomonadota
Murdochiella	Tissierellia	Bacillota
Sulfurifustis	Gammaproteobacteria	Pseudomonadota
Wenzhouxiangella	Gammaproteobacteria	Pseudomonadota
Propionivibrio	Betaproteobacteria	Pseudomonadota
Propionispora	Negativicutes	Bacillota
Cypionkella	Alphaproteobacteria	Pseudomonadota
Lentimicrobium	Bacteroidia	Bacteroidota
Candidatus Methylopumilus	Betaproteobacteria	Pseudomonadota
Akkermansia	Verrucomicrobiae	Verrucomicrobiota
Ventosimonas	Gammaproteobacteria	Pseudomonadota
Ferrigenium	Betaproteobacteria	Pseudomonadota
Zafaria	Actinomycetes	Actinomycetota
Chthonobacter	Alphaproteobacteria	Pseudomonadota
Laribacter	Betaproteobacteria	Pseudomonadota
Thiomicrospira	Gammaproteobacteria	Pseudomonadota
Kallipyga	Tissierellia	Bacillota
Sneathia	Fusobacteriia	Fusobacteriota
Gorillibacterium	Bacilli	Bacillota
Vitreoscilla	Betaproteobacteria	Pseudomonadota
Allopontixanthobacter	Alphaproteobacteria	Pseudomonadota
Citricoccus	Actinomycetes	Actinomycetota
Anaerotruncus	Clostridia	Bacillota
Finniella	Alphaproteobacteria	Pseudomonadota
Marivivens	Alphaproteobacteria	Pseudomonadota
Negativicoccus	Negativicutes	Bacillota
Niastella	Chitinophagia	Bacteroidota
Lysinibacillus	Bacilli	Bacillota
Limnothrix	Cyanophyceae	Cyanobacteriota
Sulfurirhabdus	Betaproteobacteria	Pseudomonadota
Mongoliimonas	Alphaproteobacteria	Pseudomonadota
Pyruvatibacter	Alphaproteobacteria	Pseudomonadota
Butyricicoccus	Clostridia	Bacillota
Cognatishimia	Alphaproteobacteria	Pseudomonadota
Pseudodesulfovibrio	Desulfovibrionia	Thermodesulfobacteriota
Cobetia	Gammaproteobacteria	Pseudomonadota
Labilibaculum	Bacteroidia	Bacteroidota
Dehalococcoides	Dehalococcoidia	Chloroflexota
Urinicoccus	Tissierellia	Bacillota
Dendronalium	Cyanophyceae	Cyanobacteriota
Meiothermus	Deinococci	Deinococcota
Victivallis	Lentisphaeria	Lentisphaerota
Gulosibacter	Actinomycetes	Actinomycetota
Eubacterium	Clostridia	Bacillota
Bdellovibrio	Bdellovibrionia	Bdellovibrionota
Serpentinicella	Clostridia	Bacillota
Oryzomicrobium	Betaproteobacteria	Pseudomonadota
Xylophilus	Betaproteobacteria	Pseudomonadota
Duganella	Betaproteobacteria	Pseudomonadota
Pseudorhodoferax	Betaproteobacteria	Pseudomonadota
Ramlibacter	Betaproteobacteria	Pseudomonadota
Agromyces	Actinomycetes	Actinomycetota
Frateuria	Gammaproteobacteria	Pseudomonadota
Phycicoccus	Actinomycetes	Actinomycetota
Microcella	Actinomycetes	Actinomycetota
Terrabacter	Actinomycetes	Actinomycetota
Pseudolabrys	Alphaproteobacteria	Pseudomonadota
Pseudohalioglobus	Gammaproteobacteria	Pseudomonadota
Filimonas	Chitinophagia	Bacteroidota
NA	Tissierellia	Bacillota
Kandeliimicrobium	Alphaproteobacteria	Pseudomonadota
Labrys	Alphaproteobacteria	Pseudomonadota
NA	NA	Candidatus Omnitrophota
NA	NA	Candidatus Aminicenantes
Polynucleobacter	Betaproteobacteria	Pseudomonadota
NA	Chlamydiia	Chlamydiota
Frankia	Actinomycetes	Actinomycetota
Kuenenia	Candidatus Brocadiia	Planctomycetota
Cutibacterium	Actinomycetes	Actinomycetota
Acidisoma	Alphaproteobacteria	Pseudomonadota
Acidipropionibacterium	Actinomycetes	Actinomycetota
Tenderia	Gammaproteobacteria	Pseudomonadota
Arachnia	Actinomycetes	Actinomycetota
Inmirania	Gammaproteobacteria	Pseudomonadota
Dissulfurimicrobium	Deltaproteobacteria	NA
Fluviibacter	Betaproteobacteria	Pseudomonadota
Mangrovihabitans	Actinomycetes	Actinomycetota
Solirubrum	Cytophagia	Bacteroidota
Lentibacillus	Bacilli	Bacillota
Virgisporangium	Actinomycetes	Actinomycetota
Thermotoga	Thermotogae	Thermotogota
Elizabethkingia	Flavobacteriia	Bacteroidota
Candidatus Viadribacter	Alphaproteobacteria	Pseudomonadota
Methylomagnum	Gammaproteobacteria	Pseudomonadota
Candidatus Formimonas	Clostridia	Bacillota
Prevotella	Bacteroidia	Bacteroidota
Thermus	Deinococci	Deinococcota
Lachnotalea	Clostridia	Bacillota
Saccharibacillus	Bacilli	Bacillota
Hankyongella	Alphaproteobacteria	Pseudomonadota
Acaryochloris	Cyanophyceae	Cyanobacteriota
Ferroacidibacillus	Bacilli	Bacillota
Dissulfurirhabdus	Deltaproteobacteria	NA
Actinophytocola	Actinomycetes	Actinomycetota
Tritonibacter	Alphaproteobacteria	Pseudomonadota
Chitinasiproducens	Betaproteobacteria	Pseudomonadota
Larkinella	Cytophagia	Bacteroidota
Varunaivibrio	Alphaproteobacteria	Pseudomonadota
Desulforapulum	Desulfobacteria	Thermodesulfobacteriota
Psychromarinibacter	Alphaproteobacteria	Pseudomonadota
Jiella	Alphaproteobacteria	Pseudomonadota
Coralloluteibacterium	Gammaproteobacteria	Pseudomonadota
Arsenicitalea	Alphaproteobacteria	Pseudomonadota
Marinomonas	Gammaproteobacteria	Pseudomonadota
Aurantiacibacter	Alphaproteobacteria	Pseudomonadota
Pararhodobacter	Alphaproteobacteria	Pseudomonadota
Leptospirillum	Nitrospiria	Nitrospirota
Carboxydocella	Clostridia	Bacillota
Petroclostridium	Clostridia	Bacillota
Pararobbsia	Betaproteobacteria	Pseudomonadota
Marinicella	Gammaproteobacteria	Pseudomonadota
Oscillatoria	Cyanophyceae	Cyanobacteriota
Oxalicibacterium	Betaproteobacteria	Pseudomonadota
Flexivirga	Actinomycetes	Actinomycetota
Thermodesulfatator	Thermodesulfobacteria	Thermodesulfobacteriota
Alicycliphilus	Betaproteobacteria	Pseudomonadota
Cuneatibacter	Clostridia	Bacillota
Ereboglobus	Opitutae	Verrucomicrobiota
Sarcina	Clostridia	Bacillota
Giesbergeria	Betaproteobacteria	Pseudomonadota
Robinsoniella	Clostridia	Bacillota
Steroidobacter	Gammaproteobacteria	Pseudomonadota
Ruficoccus	Opitutae	Verrucomicrobiota
Nesterenkonia	Actinomycetes	Actinomycetota
Candidatus Promineifilum	Ardenticatenia	Chloroflexota
Natronospira	Gammaproteobacteria	Pseudomonadota
Altericroceibacterium	Alphaproteobacteria	Pseudomonadota
Methylospira	Gammaproteobacteria	Pseudomonadota
Immundisolibacter	Gammaproteobacteria	Pseudomonadota
Sulfuriflexus	Gammaproteobacteria	Pseudomonadota
Jeotgalicoccus	Bacilli	Bacillota
Peteryoungia	Alphaproteobacteria	Pseudomonadota
Panacibacter	Chitinophagia	Bacteroidota
Sutterella	Betaproteobacteria	Pseudomonadota
Shinella	Alphaproteobacteria	Pseudomonadota
Sporotomaculum	Clostridia	Bacillota
Thermogemmatispora	Ktedonobacteria	Chloroflexota
Novimethylophilus	Betaproteobacteria	Pseudomonadota
Marithrix	Gammaproteobacteria	Pseudomonadota
Ochrobactrum	Alphaproteobacteria	Pseudomonadota
Dolichospermum	Cyanophyceae	Cyanobacteriota
Oculatella	Cyanophyceae	Cyanobacteriota
Tychonema	Cyanophyceae	Cyanobacteriota
Desmonostoc	Cyanophyceae	Cyanobacteriota
Roholtiella	Cyanophyceae	Cyanobacteriota
Zarconia	Cyanophyceae	Cyanobacteriota
Pseudofrankia	Actinomycetes	Actinomycetota
Macromonas	Betaproteobacteria	Pseudomonadota
NA	Deinococci	Deinococcota
Desulfotomaculum	Clostridia	Bacillota
Lacunisphaera	Opitutae	Verrucomicrobiota
Rappaport	Gammaproteobacteria	Pseudomonadota
Planctopirus	Planctomycetia	Planctomycetota
Agrococcus	Actinomycetes	Actinomycetota
Mediterranea	Bacteroidia	Bacteroidota
Pelobium	Sphingobacteriia	Bacteroidota
NA	Negativicutes	Bacillota
Allomuricauda	Flavobacteriia	Bacteroidota
NA	NA	Actinomycetota
Jannaschia	Alphaproteobacteria	Pseudomonadota
Paeniclostridium	Clostridia	Bacillota
Pseudaminobacter	Alphaproteobacteria	Pseudomonadota
Limihaloglobus	Phycisphaerae	Planctomycetota
Christensenella	Clostridia	Bacillota
Scandinavium	Gammaproteobacteria	Pseudomonadota
Orrella	Betaproteobacteria	Pseudomonadota
Rhodophyticola	Alphaproteobacteria	Pseudomonadota
Parahaliea	Gammaproteobacteria	Pseudomonadota
Roseitalea	Alphaproteobacteria	Pseudomonadota
Raoultibacter	Coriobacteriia	Actinomycetota
Duodenibacillus	Betaproteobacteria	Pseudomonadota
Perlucidibaca	Gammaproteobacteria	Pseudomonadota
Salinibius	Gammaproteobacteria	Pseudomonadota
NA	Rhodothermia	Rhodothermota
NA	Cytophagia	Bacteroidota
Trichormus	Cyanophyceae	Cyanobacteriota
Nitrosovibrio	Betaproteobacteria	Pseudomonadota
Faunimonas	Alphaproteobacteria	Pseudomonadota
Luteitalea	Vicinamibacteria	Acidobacteriota
Haoranjiania	Chitinophagia	Bacteroidota
Alteromonas	Gammaproteobacteria	Pseudomonadota
Haemophilus	Gammaproteobacteria	Pseudomonadota
Candidatus Accumulibacter	Betaproteobacteria	Pseudomonadota
Halothiobacillus	Gammaproteobacteria	Pseudomonadota
Rubrivivax	Betaproteobacteria	Pseudomonadota
Dermatophilus	Actinomycetes	Actinomycetota
Aliidongia	Alphaproteobacteria	Pseudomonadota
Humibacillus	Actinomycetes	Actinomycetota
NA	Chitinophagia	Bacteroidota
Angelakisella	Clostridia	Bacillota
Allorhizocola	Actinomycetes	Actinomycetota
Herbihabitans	Actinomycetes	Actinomycetota
Alkalilimnicola	Gammaproteobacteria	Pseudomonadota
Rhodoplanes	Alphaproteobacteria	Pseudomonadota
Thalassolituus	Gammaproteobacteria	Pseudomonadota
Notoacmeibacter	Alphaproteobacteria	Pseudomonadota
Quadrisphaera	Actinomycetes	Actinomycetota
Singulisphaera	Planctomycetia	Planctomycetota
Thermoactinomyces	Bacilli	Bacillota
Salibacterium	Bacilli	Bacillota
Pseudoflavitalea	Chitinophagia	Bacteroidota
Planktophila	Actinomycetes	Actinomycetota
Nanopelagicus	Actinomycetes	Actinomycetota
Parvibium	Betaproteobacteria	Pseudomonadota
Epidermidibacterium	Actinomycetes	Actinomycetota
Roseobacter	Alphaproteobacteria	Pseudomonadota
Neptunicoccus	Alphaproteobacteria	Pseudomonadota
Solihabitans	Actinomycetes	Actinomycetota
Allostreptomyces	Actinomycetes	Actinomycetota
Dorea	Clostridia	Bacillota
Fibrobacter	Fibrobacteria	Fibrobacterota
Desulfocucumis	Clostridia	Bacillota
Plantibacter	Actinomycetes	Actinomycetota
Tumebacillus	Bacilli	Bacillota
Oceanicoccus	Gammaproteobacteria	Pseudomonadota
Ruthenibacterium	Clostridia	Bacillota
Parageobacillus	Bacilli	Bacillota
Rodentibacter	Gammaproteobacteria	Pseudomonadota
Salinivibrio	Gammaproteobacteria	Pseudomonadota
Fimbriiglobus	Planctomycetia	Planctomycetota
Confluentibacter	Flavobacteriia	Bacteroidota
Oceanibaculum	Alphaproteobacteria	Pseudomonadota
Mangrovicoccus	Alphaproteobacteria	Pseudomonadota
Candidatus Thiodiazotropha	Gammaproteobacteria	Pseudomonadota
Christiangramia	Flavobacteriia	Bacteroidota
Pelotomaculum	Clostridia	Bacillota
Sulfuritortus	Betaproteobacteria	Pseudomonadota
Paracandidimonas	Betaproteobacteria	Pseudomonadota
Ketobacter	Gammaproteobacteria	Pseudomonadota
Chlorobium	Chlorobiia	Chlorobiota
Marinilactibacillus	Bacilli	Bacillota
Tibeticola	Betaproteobacteria	Pseudomonadota
Indiicoccus	Bacilli	Bacillota
Muribaculum	Bacteroidia	Bacteroidota
Chthoniobacter	Spartobacteria	Verrucomicrobiota
Methylotetracoccus	Gammaproteobacteria	Pseudomonadota
Archangium	Myxococcia	Myxococcota
Tardibacter	Alphaproteobacteria	Pseudomonadota
Hydrococcus	Cyanophyceae	Cyanobacteriota
Tateyamaria	Alphaproteobacteria	Pseudomonadota
Anderseniella	Alphaproteobacteria	Pseudomonadota
Anaeromassilibacillus	Clostridia	Bacillota
Sediminibacillus	Bacilli	Bacillota
Paenacidovorax	Betaproteobacteria	Pseudomonadota
Kriegella	Flavobacteriia	Bacteroidota
Adhaeretor	Planctomycetia	Planctomycetota
Rosistilla	Planctomycetia	Planctomycetota
Velamenicoccus	NA	Candidatus Omnitrophota
Marinitenerispora	Actinomycetes	Actinomycetota
Gandjariella	Actinomycetes	Actinomycetota
Streptoalloteichus	Actinomycetes	Actinomycetota
Anaerohalosphaera	Phycisphaerae	Planctomycetota
Dictyobacter	Ktedonobacteria	Chloroflexota
NA	Saprospiria	Bacteroidota
Posidoniimonas	Planctomycetia	Planctomycetota
Thalassoglobus	Planctomycetia	Planctomycetota
Rhodosalinus	Alphaproteobacteria	Pseudomonadota
Sedimentisphaera	Phycisphaerae	Planctomycetota
Alysiella	Betaproteobacteria	Pseudomonadota
Marasmitruncus	Clostridia	Bacillota
Arsenicicoccus	Actinomycetes	Actinomycetota
NA	Terriglobia	Acidobacteriota
Telluribacter	Cytophagia	Bacteroidota
NA	Desulfovibrionia	Thermodesulfobacteriota
Campylobacter	Epsilonproteobacteria	Campylobacterota
Haematobacter	Alphaproteobacteria	Pseudomonadota
Blautia	Clostridia	Bacillota
Pacificimonas	Alphaproteobacteria	Pseudomonadota
Kineosporia	Actinomycetes	Actinomycetota
Dehalobacter	Clostridia	Bacillota
Brucella	Alphaproteobacteria	Pseudomonadota
Arboricoccus	Alphaproteobacteria	Pseudomonadota
Parerythrobacter	Alphaproteobacteria	Pseudomonadota
Saezia	Betaproteobacteria	Pseudomonadota
Tuberibacillus	Bacilli	Bacillota
Anaerofilum	Clostridia	Bacillota
Flavonifractor	Clostridia	Bacillota
Pseudoflavonifractor	Clostridia	Bacillota
Albidovulum	Alphaproteobacteria	Pseudomonadota
Leptothoe	Cyanophyceae	Cyanobacteriota
Psychrobacter	Gammaproteobacteria	Pseudomonadota
Acidibrevibacterium	Alphaproteobacteria	Pseudomonadota
Ancylomarina	Bacteroidia	Bacteroidota
Sulfurivermis	Gammaproteobacteria	Pseudomonadota
Candidatus Aquicultor	Candidatus Aquicultoria	Actinomycetota
Chroococcus	Cyanophyceae	Cyanobacteriota
Terasakiispira	Gammaproteobacteria	Pseudomonadota
Aquidulcibacter	Alphaproteobacteria	Pseudomonadota
Rhodovarius	Alphaproteobacteria	Pseudomonadota
Denitratisoma	Betaproteobacteria	Pseudomonadota
Tsuneonella	Alphaproteobacteria	Pseudomonadota
Mangrovitalea	Gammaproteobacteria	Pseudomonadota
Zhengella	Alphaproteobacteria	Pseudomonadota
Brevefilum	Anaerolineae	Chloroflexota
Massiliimalia	Clostridia	Bacillota
Microtetraspora	Actinomycetes	Actinomycetota
Methylocella	Alphaproteobacteria	Pseudomonadota
NA	NA	Candidatus Latescibacteria
Parolsenella	Coriobacteriia	Actinomycetota
Cloacibacterium	Flavobacteriia	Bacteroidota
Sulfoacidibacillus	Bacilli	Bacillota
Cylindrospermum	Cyanophyceae	Cyanobacteriota
Tolypothrix	Cyanophyceae	Cyanobacteriota
Thermostichus	Cyanophyceae	Cyanobacteriota
NA	Flavobacteriia	Bacteroidota
Avrilella	Flavobacteriia	Bacteroidota
Nitratidesulfovibrio	Desulfovibrionia	Thermodesulfobacteriota
NA	NA	Thermodesulfobacteriota
Alkalicoccus	Bacilli	Bacillota
Aquipluma	Bacteroidia	Bacteroidota
Aerosticca	Gammaproteobacteria	Pseudomonadota
Desulfobacterium	Desulfobacteria	Thermodesulfobacteriota
Siccirubricoccus	Alphaproteobacteria	Pseudomonadota
Agaribacterium	Gammaproteobacteria	Pseudomonadota
Roseisolibacter	Gemmatimonadetes	Gemmatimonadota
Massilicoli	Erysipelotrichia	Bacillota
Trichothermofontia	Cyanophyceae	Cyanobacteriota
Leptothermofonsia	Cyanophyceae	Cyanobacteriota
Enemella	Actinomycetes	Actinomycetota
Nitrogeniibacter	Betaproteobacteria	Pseudomonadota
Thalassococcus	Alphaproteobacteria	Pseudomonadota
Vallotia	Betaproteobacteria	Pseudomonadota
Marinisporobacter	Clostridia	Bacillota
Planifilum	Bacilli	Bacillota
Tetzosporium	Bacilli	Bacillota
Ahniella	Gammaproteobacteria	Pseudomonadota
Novacetimonas	Alphaproteobacteria	Pseudomonadota
Elstera	Alphaproteobacteria	Pseudomonadota
Winogradskyella	Flavobacteriia	Bacteroidota
Glutamicibacter	Actinomycetes	Actinomycetota
Alkalispirochaeta	Spirochaetia	Spirochaetota
NA	Bacteriovoracia	Bdellovibrionota
Chengkuizengella	Bacilli	Bacillota
Neopusillimonas	Betaproteobacteria	Pseudomonadota
Petropleomorpha	Actinomycetes	Actinomycetota
Parasphingopyxis	Alphaproteobacteria	Pseudomonadota
NA	NA	Candidatus Campbellbacteria
NA	NA	Candidatus Saccharibacteria
NA	Myxococcia	Myxococcota
NA	Phycisphaerae	Planctomycetota
NA	NA	Candidatus Woesebacteria
Rubricella	Alphaproteobacteria	Pseudomonadota
Pollutimonas	Betaproteobacteria	Pseudomonadota
Vandammella	Betaproteobacteria	Pseudomonadota
Stenotrophobium	Gammaproteobacteria	Pseudomonadota
Pseudotabrizicola	Alphaproteobacteria	Pseudomonadota
NA	NA	Candidatus Kaiserbacteria
NA	NA	Candidatus Peregrinibacteria
Halovibrio	Gammaproteobacteria	Pseudomonadota
Methylomirabilis	NA	candidate division NC10
Longispora	Actinomycetes	Actinomycetota
Guyparkeria	Gammaproteobacteria	Pseudomonadota
Pontibacterium	Gammaproteobacteria	Pseudomonadota
NA	Mollicutes	Mycoplasmatota
Marivibrio	Alphaproteobacteria	Pseudomonadota
Allobranchiibius	Actinomycetes	Actinomycetota
Caldovatus	Alphaproteobacteria	Pseudomonadota
Neobittarella	Clostridia	Bacillota
Schaedlerella	Clostridia	Bacillota
NA	Sphingobacteriia	Bacteroidota
Pimelobacter	Actinomycetes	Actinomycetota
Salipaludibacillus	Bacilli	Bacillota
NA	NA	Candidatus Moranbacteria
Dongshaea	Gammaproteobacteria	Pseudomonadota
Mogibacterium	Clostridia	Bacillota
NA	Anaerolineae	Chloroflexota
NA	NA	Candidatus Nomurabacteria
NA	NA	Fibrobacterota
Aquiluna	Actinomycetes	Actinomycetota
NA	NA	Candidatus Uhrbacteria
Minwuia	Alphaproteobacteria	Pseudomonadota
Acidimangrovimonas	Alphaproteobacteria	Pseudomonadota
Phycocomes	Alphaproteobacteria	Pseudomonadota
Sphaerobacter	Thermomicrobia	Thermomicrobiota
Lacinutrix	Flavobacteriia	Bacteroidota
Marinicaulis	Alphaproteobacteria	Pseudomonadota
Rummeliibacillus	Bacilli	Bacillota
Moritella	Gammaproteobacteria	Pseudomonadota
Pseudochryseolinea	Cytophagia	Bacteroidota
Salinibacterium	Actinomycetes	Actinomycetota
Zobellella	Gammaproteobacteria	Pseudomonadota
Chimaeribacter	Gammaproteobacteria	Pseudomonadota
Pradoshia	Bacilli	Bacillota
Desertimonas	Acidimicrobiia	Actinomycetota
Kerstersia	Betaproteobacteria	Pseudomonadota
Hydrogenovibrio	Gammaproteobacteria	Pseudomonadota
Aquella	Betaproteobacteria	Pseudomonadota
Pseudazoarcus	Betaproteobacteria	Pseudomonadota
Novisyntrophococcus	Clostridia	Bacillota
Tamlana	Flavobacteriia	Bacteroidota
Enteroscipio	Coriobacteriia	Actinomycetota
Meridianimarinicoccus	Alphaproteobacteria	Pseudomonadota
Adhaeribacter	Cytophagia	Bacteroidota
Actinotalea	Actinomycetes	Actinomycetota
Flavipsychrobacter	Chitinophagia	Bacteroidota
Actinocorallia	Actinomycetes	Actinomycetota
Rhodohalobacter	Balneolia	Balneolota
Tautonia	Planctomycetia	Planctomycetota
Phytohalomonas	Gammaproteobacteria	Pseudomonadota
Pseudalkalibacillus	Bacilli	Bacillota
Parabacteroides	Bacteroidia	Bacteroidota
Maliibacterium	Clostridia	Bacillota
Amnimonas	Gammaproteobacteria	Pseudomonadota
Solimicrobium	Betaproteobacteria	Pseudomonadota
Rhabdochlamydia	Chlamydiia	Chlamydiota
Brumimicrobium	Flavobacteriia	Bacteroidota
Chlorogloea	Cyanophyceae	Cyanobacteriota
Aphanothece	Cyanophyceae	Cyanobacteriota
Stenomitos	Cyanophyceae	Cyanobacteriota
Tepiditoga	Thermotogae	Thermotogota
Pulveribacter	Betaproteobacteria	Pseudomonadota
Nissabacter	Gammaproteobacteria	Pseudomonadota
Peterkaempfera	Actinomycetes	Actinomycetota
Rugamonas	Betaproteobacteria	Pseudomonadota
Geothermobacter	Desulfuromonadia	Thermodesulfobacteriota
NA	Desulfuromonadia	Thermodesulfobacteriota
NA	Syntrophobacteria	Thermodesulfobacteriota
NA	Bdellovibrionia	Bdellovibrionota
Pseudothauera	Betaproteobacteria	Pseudomonadota
Oceaniglobus	Alphaproteobacteria	Pseudomonadota
Thermoflavimicrobium	Bacilli	Bacillota
Ellagibacter	Coriobacteriia	Actinomycetota
Vitiosangium	Myxococcia	Myxococcota
Enhygromyxa	Myxococcia	Myxococcota
Hyphobacterium	Alphaproteobacteria	Pseudomonadota
Algihabitans	Alphaproteobacteria	Pseudomonadota
Faecalibacterium	Clostridia	Bacillota
Pelagivirga	Alphaproteobacteria	Pseudomonadota
Thalassorhabdomicrobium	Alphaproteobacteria	Pseudomonadota
Stella	Alphaproteobacteria	Pseudomonadota
Arcicella	Cytophagia	Bacteroidota
Oleisolibacter	Alphaproteobacteria	Pseudomonadota
Brocadia	Candidatus Brocadiia	Planctomycetota
Pararcticibacter	Sphingobacteriia	Bacteroidota
Albibacillus	Alphaproteobacteria	Pseudomonadota
Coraliomargarita	Opitutae	Verrucomicrobiota
Fulvimarina	Alphaproteobacteria	Pseudomonadota
Ancrocorticia	Actinomycetes	Actinomycetota
Garciella	Clostridia	Bacillota
Nitrotoga	Betaproteobacteria	Pseudomonadota
Abyssibacter	Gammaproteobacteria	Pseudomonadota
Oceaniradius	Alphaproteobacteria	Pseudomonadota
NA	Gemmatimonadetes	Gemmatimonadota
Litorivita	Alphaproteobacteria	Pseudomonadota
Falsochrobactrum	Alphaproteobacteria	Pseudomonadota
Isoalcanivorax	Gammaproteobacteria	Pseudomonadota
Sulfuricystis	Betaproteobacteria	Pseudomonadota
Sedimentitalea	Alphaproteobacteria	Pseudomonadota
Acidisarcina	Terriglobia	Acidobacteriota
Algibacter	Flavobacteriia	Bacteroidota
Homoserinimonas	Actinomycetes	Actinomycetota
Candidatus Competibacter	Gammaproteobacteria	Pseudomonadota
Mastigocladopsis	Cyanophyceae	Cyanobacteriota
Putridiphycobacter	Flavobacteriia	Bacteroidota
Indioceanicola	Alphaproteobacteria	Pseudomonadota
Parafrankia	Actinomycetes	Actinomycetota
Roseicella	Alphaproteobacteria	Pseudomonadota
Brasilonema	Cyanophyceae	Cyanobacteriota
Methylorubrum	Alphaproteobacteria	Pseudomonadota
Pyxidicoccus	Myxococcia	Myxococcota
Lewinella	Saprospiria	Bacteroidota
Leeuwenhoekiella	Flavobacteriia	Bacteroidota
Sumerlaea	Candidatus Sumerlaeia	Candidatus Sumerlaeota
NA	Acidithiobacillia	Pseudomonadota
Pseudogemmobacter	Alphaproteobacteria	Pseudomonadota
Enhydrobacter	Alphaproteobacteria	Pseudomonadota
Aestuariibacter	Gammaproteobacteria	Pseudomonadota
Ephemeroptericola	Betaproteobacteria	Pseudomonadota
Dongia	Alphaproteobacteria	Pseudomonadota
NA	NA	Chlorobiota
Desertihabitans	Actinomycetes	Actinomycetota
Paracnuella	Chitinophagia	Bacteroidota
Ulvibacter	Flavobacteriia	Bacteroidota
NA	NA	Candidatus Roizmanbacteria
Leclercia	Gammaproteobacteria	Pseudomonadota
Aquirhabdus	Gammaproteobacteria	Pseudomonadota
Saccharophagus	Gammaproteobacteria	Pseudomonadota
Maribacter	Flavobacteriia	Bacteroidota
Cryosericum	Candidatus Cryosericia	Candidatus Cryosericota
Trinickia	Betaproteobacteria	Pseudomonadota
Gallaecimonas	Gammaproteobacteria	Pseudomonadota
Deminuibacter	Chitinophagia	Bacteroidota
Undibacter	Alphaproteobacteria	Pseudomonadota
Roseburia	Clostridia	Bacillota
Methylovirgula	Alphaproteobacteria	Pseudomonadota
Candidatus Jettenia	Candidatus Brocadiia	Planctomycetota
Anaerolinea	Anaerolineae	Chloroflexota
Leptolinea	Anaerolineae	Chloroflexota
Levilinea	Anaerolineae	Chloroflexota
Thermoleptolyngbya	Cyanophyceae	Cyanobacteriota
Paracidobacterium	Terriglobia	Acidobacteriota
Enterorhabdus	Coriobacteriia	Actinomycetota
Breoghania	Alphaproteobacteria	Pseudomonadota
Antribacter	Actinomycetes	Actinomycetota
Reinekea	Gammaproteobacteria	Pseudomonadota
Acidipila	Terriglobia	Acidobacteriota
Longirhabdus	Bacilli	Bacillota
Macondimonas	Gammaproteobacteria	Pseudomonadota
Maribellus	Bacteroidia	Bacteroidota
Fibrisoma	Cytophagia	Bacteroidota
Pelagerythrobacter	Alphaproteobacteria	Pseudomonadota
Galacturonibacter	Clostridia	Bacillota
Desulfoluna	Desulfobacteria	Thermodesulfobacteriota
Paraflavitalea	Chitinophagia	Bacteroidota
Mediterraneibacter	Clostridia	Bacillota
Lichenibacterium	Alphaproteobacteria	Pseudomonadota
Acutalibacter	Clostridia	Bacillota
Oleomonas	Alphaproteobacteria	Pseudomonadota
Chryseolinea	Cytophagia	Bacteroidota
Dulcicalothrix	Cyanophyceae	Cyanobacteriota
Halanaerobium	Clostridia	Bacillota
Ectothiorhodosinus	Gammaproteobacteria	Pseudomonadota
Caldilinea	Caldilineae	Chloroflexota
Vallicoccus	Actinomycetes	Actinomycetota
Chachezhania	Alphaproteobacteria	Pseudomonadota
Planotetraspora	Actinomycetes	Actinomycetota
Alistipes	Bacteroidia	Bacteroidota
Xylella	Gammaproteobacteria	Pseudomonadota
Oribacterium	Clostridia	Bacillota
Pyramidobacter	Synergistia	Synergistota
Desulfurobacterium	Aquificae	Aquificota
Halobacillus	Bacilli	Bacillota
Fervidobacterium	Thermotogae	Thermotogota
NA	Acidimicrobiia	Actinomycetota
Anaerospora	Negativicutes	Bacillota
Chroogloeocystis	Cyanophyceae	Cyanobacteriota
NA	Holophagae	Acidobacteriota
Poseidonibacter	Epsilonproteobacteria	Campylobacterota
Gynurincola	Chitinophagia	Bacteroidota
Trebonia	Actinomycetes	Actinomycetota
Lujinxingia	Deltaproteobacteria	NA
Parasedimentitalea	Alphaproteobacteria	Pseudomonadota
Veillonella	Negativicutes	Bacillota
Lutibacter	Flavobacteriia	Bacteroidota
Frigoribacterium	Actinomycetes	Actinomycetota
Acetivibrio	Clostridia	Bacillota
Lacihabitans	Cytophagia	Bacteroidota
Arthrospiribacter	Cytophagia	Bacteroidota
Lachnoanaerobaculum	Clostridia	Bacillota
Lautropia	Betaproteobacteria	Pseudomonadota
Leptotrichia	Fusobacteriia	Fusobacteriota
Solirhodobacter	Alphaproteobacteria	Pseudomonadota
Tabrizicola	Alphaproteobacteria	Pseudomonadota
Aquabacter	Alphaproteobacteria	Pseudomonadota
Seramator	Bacteroidia	Bacteroidota
Roseococcus	Alphaproteobacteria	Pseudomonadota
Magnetaquicoccus	Alphaproteobacteria	Pseudomonadota
Candidatus Chloroploca	Chloroflexia	Chloroflexota
Albitalea	Betaproteobacteria	Pseudomonadota
Candidimonas	Betaproteobacteria	Pseudomonadota
Goekera	Actinomycetes	Actinomycetota
Cellulosilyticum	Clostridia	Bacillota
Peristeroidobacter	Gammaproteobacteria	Pseudomonadota
Candidatus Cryosericum	Candidatus Cryosericia	Candidatus Cryosericota
Zeimonas	Betaproteobacteria	Pseudomonadota
Inhella	Betaproteobacteria	Pseudomonadota
Apibacter	Flavobacteriia	Bacteroidota
Bipolaricaulis	NA	Candidatus Bipolaricaulota
Telmatospirillum	Alphaproteobacteria	Pseudomonadota
Chitinivorax	Betaproteobacteria	Pseudomonadota
Pseudocnuella	Chitinophagia	Bacteroidota
Caproiciproducens	Clostridia	Bacillota
Lacibacter	Chitinophagia	Bacteroidota
Oleiharenicola	Opitutae	Verrucomicrobiota
Candidatus Borkfalkia	Clostridia	Bacillota
Oryzomonas	Desulfuromonadia	Thermodesulfobacteriota
Ktedonosporobacter	Ktedonobacteria	Chloroflexota
Pseudolysobacter	Gammaproteobacteria	Pseudomonadota
Aquirufa	Cytophagia	Bacteroidota
Seongchinamella	Gammaproteobacteria	Pseudomonadota
Marimicrobium	Gammaproteobacteria	Pseudomonadota
Paraluminiphilus	Gammaproteobacteria	Pseudomonadota
Aeoliella	Planctomycetia	Planctomycetota
Stratiformator	Planctomycetia	Planctomycetota
Caulifigura	Planctomycetia	Planctomycetota
Alienimonas	Planctomycetia	Planctomycetota
Pseudobythopirellula	Planctomycetia	Planctomycetota
Symmachiella	Planctomycetia	Planctomycetota
Botrimarina	Planctomycetia	Planctomycetota
Bythopirellula	Planctomycetia	Planctomycetota
Novipirellula	Planctomycetia	Planctomycetota
Stieleria	Planctomycetia	Planctomycetota
Pirellulimonas	Planctomycetia	Planctomycetota
Lignipirellula	Planctomycetia	Planctomycetota
Anatilimnocola	Planctomycetia	Planctomycetota
Urbifossiella	Planctomycetia	Planctomycetota
Lacipirellula	Planctomycetia	Planctomycetota
Maioricimonas	Planctomycetia	Planctomycetota
Calycomorphotria	Planctomycetia	Planctomycetota
Parasulfuritortus	Betaproteobacteria	Pseudomonadota
Seonamhaeicola	Flavobacteriia	Bacteroidota
Aestuariirhabdus	Gammaproteobacteria	Pseudomonadota
Lichenihabitans	Alphaproteobacteria	Pseudomonadota
Planctomonas	Actinomycetes	Actinomycetota
Acetomicrobium	Synergistia	Synergistota
Acidaminobacter	Clostridia	Bacillota
Microseira	Cyanophyceae	Cyanobacteriota
Aquicella	Gammaproteobacteria	Pseudomonadota
Roseibaca	Alphaproteobacteria	Pseudomonadota
Roseisalinus	Alphaproteobacteria	Pseudomonadota
Arachidicoccus	Chitinophagia	Bacteroidota
Marimonas	Alphaproteobacteria	Pseudomonadota
Antarcticimicrobium	Alphaproteobacteria	Pseudomonadota
Jeotgalibacillus	Bacilli	Bacillota
Propylenella	Alphaproteobacteria	Pseudomonadota
Oecophyllibacter	Alphaproteobacteria	Pseudomonadota
Formicincola	Alphaproteobacteria	Pseudomonadota
Vitreimonas	Alphaproteobacteria	Pseudomonadota
Rhodoligotrophos	Alphaproteobacteria	Pseudomonadota
Sinimarinibacterium	Gammaproteobacteria	Pseudomonadota
Geomonas	Desulfuromonadia	Thermodesulfobacteriota
Pacificoceanicola	Alphaproteobacteria	Pseudomonadota
Pontibacter	Cytophagia	Bacteroidota
Microcoleus	Cyanophyceae	Cyanobacteriota
Parasutterella	Betaproteobacteria	Pseudomonadota
Paucihalobacter	Flavobacteriia	Bacteroidota
Polyangium	NA	Myxococcota
Desulfosediminicola	Desulfobulbia	Thermodesulfobacteriota
Candidatus Bandiella	Alphaproteobacteria	Pseudomonadota
Chitiniphilus	Betaproteobacteria	Pseudomonadota
Mycetohabitans	Betaproteobacteria	Pseudomonadota
Ornithinicoccus	Actinomycetes	Actinomycetota
Aquibacillus	Bacilli	Bacillota
Phragmitibacter	Verrucomicrobiae	Verrucomicrobiota
Nibricoccus	Opitutae	Verrucomicrobiota
Zongyanglinia	Alphaproteobacteria	Pseudomonadota
Jejubacter	Gammaproteobacteria	Pseudomonadota
Paroceanicella	Alphaproteobacteria	Pseudomonadota
Desulfohalovibrio	Desulfovibrionia	Thermodesulfobacteriota
Luteithermobacter	Alphaproteobacteria	Pseudomonadota
Antrihabitans	Actinomycetes	Actinomycetota
Companilactobacillus	Bacilli	Bacillota
Desulfobotulus	Desulfobacteria	Thermodesulfobacteriota
Vineibacter	Alphaproteobacteria	Pseudomonadota
Amaricoccus	Alphaproteobacteria	Pseudomonadota
Schumannella	Actinomycetes	Actinomycetota
Exilibacterium	Gammaproteobacteria	Pseudomonadota
Denitrobaculum	Alphaproteobacteria	Pseudomonadota
Casimicrobium	Betaproteobacteria	Pseudomonadota
Glacieibacterium	Alphaproteobacteria	Pseudomonadota
Selenomonas	Negativicutes	Bacillota
Kaustia	Alphaproteobacteria	Pseudomonadota
Ferrovibrio	Alphaproteobacteria	Pseudomonadota
Lacisediminihabitans	Actinomycetes	Actinomycetota
Candidatus Uabimicrobium	Candidatus Uabimicrobiia	Planctomycetota
Alkalicoccobacillus	Bacilli	Bacillota
Tomitella	Actinomycetes	Actinomycetota
Fluviicola	Flavobacteriia	Bacteroidota
Rariglobus	Opitutae	Verrucomicrobiota
Limnoglobus	Planctomycetia	Planctomycetota
Microvenator	Deltaproteobacteria	NA
Baekduia	Thermoleophilia	Actinomycetota
Sideroxydans	Betaproteobacteria	Pseudomonadota
Edaphocola	Chitinophagia	Bacteroidota
Hypericibacter	Alphaproteobacteria	Pseudomonadota
Pelomicrobium	Hydrogenophilia	Pseudomonadota
Ruania	Actinomycetes	Actinomycetota
Lacisediminimonas	Betaproteobacteria	Pseudomonadota
Rhabdaerophilum	Alphaproteobacteria	Pseudomonadota
Lolliginicoccus	Actinomycetes	Actinomycetota
Roseiconus	Planctomycetia	Planctomycetota
Pukyongiella	Alphaproteobacteria	Pseudomonadota
Manganitrophus	Nitrospiria	Nitrospirota
Sodaliphilus	Bacteroidia	Bacteroidota
Antarcticirhabdus	Alphaproteobacteria	Pseudomonadota
Calorimonas	Clostridia	Bacillota
Ginsengibacter	Chitinophagia	Bacteroidota
Stammera	Gammaproteobacteria	Pseudomonadota
Asaia	Alphaproteobacteria	Pseudomonadota
Parvibaculum	Alphaproteobacteria	Pseudomonadota
Foetidibacter	Chitinophagia	Bacteroidota
Segnochrobactrum	Alphaproteobacteria	Pseudomonadota
Rathayibacter	Actinomycetes	Actinomycetota
Kineococcus	Actinomycetes	Actinomycetota
Marinihelvus	Gammaproteobacteria	Pseudomonadota
Histidinibacterium	Alphaproteobacteria	Pseudomonadota
Rudanella	Cytophagia	Bacteroidota
Pseudoclavibacter	Actinomycetes	Actinomycetota
Methylococcus	Gammaproteobacteria	Pseudomonadota
Kangiella	Gammaproteobacteria	Pseudomonadota
Erwinia	Gammaproteobacteria	Pseudomonadota
Solwaraspora	Actinomycetes	Actinomycetota
Trichocoleus	Cyanophyceae	Cyanobacteriota
Geomicrobium	Bacilli	Bacillota
Imperialibacter	Cytophagia	Bacteroidota
Citromicrobium	Alphaproteobacteria	Pseudomonadota
Malikia	Betaproteobacteria	Pseudomonadota
Lentimonas	NA	Verrucomicrobiota
Providencia	Gammaproteobacteria	Pseudomonadota
Viridibacillus	Bacilli	Bacillota
Flammeovirga	Cytophagia	Bacteroidota
Solibacillus	Bacilli	Bacillota
NA	NA	Atribacterota
Flagellimonas	Flavobacteriia	Bacteroidota
Exiguobacterium	Bacilli	Bacillota
Barnesiella	Bacteroidia	Bacteroidota
Thermodesulfovibrio	Thermodesulfovibrionia	Nitrospirota
Sphaerospermopsis	Cyanophyceae	Cyanobacteriota
Aestuariivirga	Alphaproteobacteria	Pseudomonadota
Kingella	Betaproteobacteria	Pseudomonadota
Holdemanella	Erysipelotrichia	Bacillota
Kovacikia	Cyanophyceae	Cyanobacteriota
Alkalibaculum	Clostridia	Bacillota
Limnovirga	Chitinophagia	Bacteroidota
Fertoeibacter	Alphaproteobacteria	Pseudomonadota
Aquimonas	Gammaproteobacteria	Pseudomonadota
Castellaniella	Betaproteobacteria	Pseudomonadota
Venatoribacter	Gammaproteobacteria	Pseudomonadota
Ferruginivarius	Alphaproteobacteria	Pseudomonadota
Roseimaritima	Planctomycetia	Planctomycetota
Raineyella	Actinomycetes	Actinomycetota
Halovulum	Alphaproteobacteria	Pseudomonadota
Thiosulfatimonas	Gammaproteobacteria	Pseudomonadota
Occultella	Actinomycetes	Actinomycetota
Pseudomethylobacillus	Betaproteobacteria	Pseudomonadota
Galactobacter	Actinomycetes	Actinomycetota
Coxiella	Gammaproteobacteria	Pseudomonadota
Phnomibacter	Chitinophagia	Bacteroidota
Ornithinibacillus	Bacilli	Bacillota
Chelativorans	Alphaproteobacteria	Pseudomonadota
Tepidiforma	Tepidiformia	Chloroflexota
Xiamenia	Coriobacteriia	Actinomycetota
Telluria	Betaproteobacteria	Pseudomonadota
Spartinivicinus	Gammaproteobacteria	Pseudomonadota
Zwartia	Betaproteobacteria	Pseudomonadota
Lichenicoccus	Alphaproteobacteria	Pseudomonadota
Cognatazoarcus	Betaproteobacteria	Pseudomonadota
Craterilacuibacter	Betaproteobacteria	Pseudomonadota
Terricaulis	Alphaproteobacteria	Pseudomonadota
Vondammii	Gammaproteobacteria	Pseudomonadota
Rothia	Actinomycetes	Actinomycetota
Stagnimonas	Gammaproteobacteria	Pseudomonadota
Myxacorys	Cyanophyceae	Cyanobacteriota
Acerihabitans	Gammaproteobacteria	Pseudomonadota
Sunxiuqinia	Bacteroidia	Bacteroidota
Alkalinema	Cyanophyceae	Cyanobacteriota
Oceanomicrobium	Alphaproteobacteria	Pseudomonadota
Hufsiella	Sphingobacteriia	Bacteroidota
Aristophania	Alphaproteobacteria	Pseudomonadota
Tichowtungia	Tichowtungiia	Kiritimatiellota
Bhargavaea	Bacilli	Bacillota
Heliomicrobium	Clostridia	Bacillota
Capillibacterium	NA	Bacillota
Caldichromatium	Gammaproteobacteria	Pseudomonadota
Limnofasciculus	Cyanophyceae	Cyanobacteriota
Gardnerella	Actinomycetes	Actinomycetota
Roseilinea	Candidatus Thermofonsia	Chloroflexota
Catenulispora	Actinomycetes	Actinomycetota
Candidatus Nitrohelix	Nitrospinia	Nitrospinota
Tepidicella	Betaproteobacteria	Pseudomonadota
Pseudolysinimonas	Actinomycetes	Actinomycetota
Marisediminicola	Actinomycetes	Actinomycetota
Nordella	Alphaproteobacteria	Pseudomonadota
Salaquimonas	Alphaproteobacteria	Pseudomonadota
Pseudenhygromyxa	NA	Myxococcota
Thalassoroseus	Planctomycetia	Planctomycetota
Crateriforma	Planctomycetia	Planctomycetota
Neorhodopirellula	Planctomycetia	Planctomycetota
Perlabentimonas	Bacteroidia	Bacteroidota
Sulfurimicrobium	Betaproteobacteria	Pseudomonadota
Dissulfurispira	Thermodesulfovibrionia	Nitrospirota
Laspinema	Cyanophyceae	Cyanobacteriota
Gephyromycinifex	Actinomycetes	Actinomycetota
NA	Ktedonobacteria	Chloroflexota
Cardiobacterium	Gammaproteobacteria	Pseudomonadota
Rhizohabitans	Actinomycetes	Actinomycetota
Marinagarivorans	Gammaproteobacteria	Pseudomonadota
Iamia	Acidimicrobiia	Actinomycetota
Tepidanaerobacter	Clostridia	Bacillota
Adlercreutzia	Coriobacteriia	Actinomycetota
Haematospirillum	Alphaproteobacteria	Pseudomonadota
Pacificispira	Alphaproteobacteria	Pseudomonadota
Sulfobacillus	Clostridia	Bacillota
Usitatibacter	Betaproteobacteria	Pseudomonadota
Symbiobacterium	Clostridia	Bacillota
Leptothrix	Betaproteobacteria	Pseudomonadota
Frigoriflavimonas	Flavobacteriia	Bacteroidota
Alterinioella	Alphaproteobacteria	Pseudomonadota
Syntrophothermus	Clostridia	Bacillota
Vagococcus	Bacilli	Bacillota
Micropruina	Actinomycetes	Actinomycetota
NA	Chthonomonadetes	Armatimonadota
Desulfofustis	Desulfobulbia	Thermodesulfobacteriota
Peptococcus	Clostridia	Bacillota
Marinifaba	Gammaproteobacteria	Pseudomonadota
Limosilactobacillus	Bacilli	Bacillota
Salicibibacter	Bacilli	Bacillota
Candidatus Methylacidithermus	Methylacidiphilae	Verrucomicrobiota
Pikeienuella	Alphaproteobacteria	Pseudomonadota
Oceaniferula	Verrucomicrobiae	Verrucomicrobiota
Iningainema	Cyanophyceae	Cyanobacteriota
Salinicoccus	Bacilli	Bacillota
NA	NA	Candidatus Sungbacteria
Pontiella	Kiritimatiellia	Kiritimatiellota
Rhabdothermincola	Acidimicrobiia	Actinomycetota
Haloechinothrix	Actinomycetes	Actinomycetota
Thermohalobaculum	Alphaproteobacteria	Pseudomonadota
Hakubella	NA	Actinomycetota
Mesopusillimonas	Betaproteobacteria	Pseudomonadota
Variimorphobacter	Clostridia	Bacillota
Thermogemmata	Planctomycetia	Planctomycetota
Sediminihaliea	Gammaproteobacteria	Pseudomonadota
Schaalia	Actinomycetes	Actinomycetota
Thermaurantiacus	Alphaproteobacteria	Pseudomonadota
Sandaracinobacteroides	Alphaproteobacteria	Pseudomonadota
Aquariibacter	Betaproteobacteria	Pseudomonadota
Natronospirillum	Gammaproteobacteria	Pseudomonadota
Daejeonella	Sphingobacteriia	Bacteroidota
Pelagibius	Alphaproteobacteria	Pseudomonadota
Dysosmobacter	Clostridia	Bacillota
Alloacidobacterium	Terriglobia	Acidobacteriota
Boseongicola	Alphaproteobacteria	Pseudomonadota
Gehongia	Clostridia	Bacillota
Ligaoa	Clostridia	Bacillota
Zhenhengia	Clostridia	Bacillota
Sideroxyarcus	Betaproteobacteria	Pseudomonadota
Oryzibacter	Alphaproteobacteria	Pseudomonadota
Taishania	Flavobacteriia	Bacteroidota
Oryzicola	Alphaproteobacteria	Pseudomonadota
Halomicronema	Cyanophyceae	Cyanobacteriota
Levilactobacillus	Bacilli	Bacillota
Candidatus Laterigemmans	Planctomycetia	Planctomycetota
Pelovirga	Desulfuromonadia	Thermodesulfobacteriota
Neiella	Gammaproteobacteria	Pseudomonadota
Pelorhabdus	Negativicutes	Bacillota
Desulfolutivibrio	Desulfovibrionia	Thermodesulfobacteriota
Pelagicoccus	Opitutae	Verrucomicrobiota
Aestuariimicrobium	Actinomycetes	Actinomycetota
Kluyvera	Gammaproteobacteria	Pseudomonadota
Pseudomarimonas	Gammaproteobacteria	Pseudomonadota
Frigoriglobus	Planctomycetia	Planctomycetota
Myceligenerans	Actinomycetes	Actinomycetota
Romeriopsis	Cyanophyceae	Cyanobacteriota
Ktedonobacter	Ktedonobacteria	Chloroflexota
Halonatronomonas	Clostridia	Bacillota
Anthocerotibacter	Cyanophyceae	Cyanobacteriota
Methyloradius	Betaproteobacteria	Pseudomonadota
Marixanthomonas	Flavobacteriia	Bacteroidota
Faecalibacter	Flavobacteriia	Bacteroidota
NA	Lentisphaeria	Lentisphaerota
Petrachloros	Cyanophyceae	Cyanobacteriota
Chryseosolibacter	Cytophagia	Bacteroidota
Dawidia	Cytophagia	Bacteroidota
Anaeromicropila	Clostridia	Bacillota
Nucisporomicrobium	Actinomycetes	Actinomycetota
Pinirhizobacter	Gammaproteobacteria	Pseudomonadota
Geminisphaera	Opitutae	Verrucomicrobiota
Terriglobus	Terriglobia	Acidobacteriota
Actinomarinicola	Acidimicrobiia	Actinomycetota
Thermincola	Clostridia	Bacillota
Amazonocrinis	Cyanophyceae	Cyanobacteriota
Symbiopectobacterium	Gammaproteobacteria	Pseudomonadota
Desulfolithobacter	Desulfobulbia	Thermodesulfobacteriota
Sulfurimonas	Epsilonproteobacteria	Campylobacterota
Parachlamydia	Chlamydiia	Chlamydiota
Methylacidimicrobium	NA	Verrucomicrobiota
Geomesophilobacter	Desulfuromonadia	Thermodesulfobacteriota
Mammaliicoccus	Bacilli	Bacillota
Fuscibacter	Alphaproteobacteria	Pseudomonadota
Yinghuangia	Actinomycetes	Actinomycetota
Flagellatimonas	Gammaproteobacteria	Pseudomonadota
Neotabrizicola	Alphaproteobacteria	Pseudomonadota
Humisphaera	Phycisphaerae	Planctomycetota
Actinocatenispora	Actinomycetes	Actinomycetota
Parashewanella	Gammaproteobacteria	Pseudomonadota
NA	Epsilonproteobacteria	Campylobacterota
Paralysiella	Betaproteobacteria	Pseudomonadota
Robbsia	Betaproteobacteria	Pseudomonadota
Aridibaculum	Chitinophagia	Bacteroidota
Tannerella	Bacteroidia	Bacteroidota
Amphritea	Gammaproteobacteria	Pseudomonadota
Sabulicella	Alphaproteobacteria	Pseudomonadota
NA	Thermodesulfovibrionia	Nitrospirota
Longitalea	Chitinophagia	Bacteroidota
Arenibaculum	Alphaproteobacteria	Pseudomonadota
Herbiconiux	Actinomycetes	Actinomycetota
Sulfurospirillum	Epsilonproteobacteria	Campylobacterota
Rikenella	Bacteroidia	Bacteroidota
Yersinia	Gammaproteobacteria	Pseudomonadota
Alkalibacter	Clostridia	Bacillota
Pinisolibacter	Alphaproteobacteria	Pseudomonadota
Spirabiliibacterium	Gammaproteobacteria	Pseudomonadota
Naasia	Actinomycetes	Actinomycetota
Sinanaerobacter	Clostridia	Bacillota
Magnetovibrio	Alphaproteobacteria	Pseudomonadota
Sulfidibacter	Holophagae	Acidobacteriota
NA	NA	Myxococcota
Pengzhenrongella	Actinomycetes	Actinomycetota
Thermonema	Cytophagia	Bacteroidota
Sagittula	Alphaproteobacteria	Pseudomonadota
Hydrogenophilus	Hydrogenophilia	Pseudomonadota
Pararoseomonas	Alphaproteobacteria	Pseudomonadota
Gottfriedia	Bacilli	Bacillota
Tropicibacter	Alphaproteobacteria	Pseudomonadota
Candidatus Protochlamydia	Chlamydiia	Chlamydiota
Desulfobacula	Desulfobacteria	Thermodesulfobacteriota
Stakelama	Alphaproteobacteria	Pseudomonadota
Oceanirhabdus	Clostridia	Bacillota
Paraneptunicella	Gammaproteobacteria	Pseudomonadota
Desulfovulcanus	Desulfovibrionia	Thermodesulfobacteriota
Pseudochrobactrum	Alphaproteobacteria	Pseudomonadota
Leptodesmis	Cyanophyceae	Cyanobacteriota
Phosphitispora	Clostridia	Bacillota
Sutcliffiella	Bacilli	Bacillota
Methylomarinovum	Gammaproteobacteria	Pseudomonadota
Prosthecodimorpha	Alphaproteobacteria	Pseudomonadota
Acetanaerobacterium	Clostridia	Bacillota
Citreicella	Alphaproteobacteria	Pseudomonadota
Miltoncostaea	Thermoleophilia	Actinomycetota
Herbidospora	Actinomycetes	Actinomycetota
Geoalkalibacter	Desulfuromonadia	Thermodesulfobacteriota
Atribacter	Atribacteria	Atribacterota
Aquihabitans	Acidimicrobiia	Actinomycetota
Sedimentimonas	Alphaproteobacteria	Pseudomonadota
Anianabacter	Alphaproteobacteria	Pseudomonadota
Pinibacter	Chitinophagia	Bacteroidota
Phytoplasma	Mollicutes	Mycoplasmatota
Flavimobilis	Actinomycetes	Actinomycetota
Pseudoruegeria	Alphaproteobacteria	Pseudomonadota
Pseudemcibacter	Alphaproteobacteria	Pseudomonadota
Pseudohoeflea	Alphaproteobacteria	Pseudomonadota
Hyalangium	Myxococcia	Myxococcota
Horticoccus	Opitutae	Verrucomicrobiota
Motilimonas	Gammaproteobacteria	Pseudomonadota
Flavimaribacter	Alphaproteobacteria	Pseudomonadota
Oscillochloris	Chloroflexia	Chloroflexota
Tunicatimonas	Cytophagia	Bacteroidota
Acidiferrimicrobium	Acidimicrobiia	Actinomycetota
Parachryseolinea	Cytophagia	Bacteroidota
Psittacicella	Gammaproteobacteria	Pseudomonadota
Macrococcus	Bacilli	Bacillota
Argonema	Cyanophyceae	Cyanobacteriota
Jidongwangia	Actinomycetes	Actinomycetota
Beggiatoa	Gammaproteobacteria	Pseudomonadota
Fusicatenibacter	Clostridia	Bacillota
Capillimicrobium	Thermoleophilia	Actinomycetota
Dermatobacter	Acidimicrobiia	Actinomycetota
Planobispora	Actinomycetes	Actinomycetota
Roseithermus	Rhodothermia	Rhodothermota
Scleromatobacter	Betaproteobacteria	Pseudomonadota
Merdimmobilis	Clostridia	Bacillota
Aquincola	Betaproteobacteria	Pseudomonadota
Borrelia	Spirochaetia	Spirochaetota
Rubinisphaera	Planctomycetia	Planctomycetota
Pseudophaeobacter	Alphaproteobacteria	Pseudomonadota
Candidatus Solincola	Candidatus Geothermincolia	Actinomycetota
Paralcaligenes	Betaproteobacteria	Pseudomonadota
Roseivirga	Cytophagia	Bacteroidota
Pedomonas	Alphaproteobacteria	Pseudomonadota
Solicola	Actinomycetes	Actinomycetota
Octadecabacter	Alphaproteobacteria	Pseudomonadota
Maritalea	Alphaproteobacteria	Pseudomonadota
Geotalea	Desulfuromonadia	Thermodesulfobacteriota
Gelidibacter	Flavobacteriia	Bacteroidota
Sphaerotilus	Betaproteobacteria	Pseudomonadota
Epibacterium	Alphaproteobacteria	Pseudomonadota
Wielerella	Betaproteobacteria	Pseudomonadota
Avibacterium	Gammaproteobacteria	Pseudomonadota
Desulforhabdus	Syntrophobacteria	Thermodesulfobacteriota
Mesosutterella	Betaproteobacteria	Pseudomonadota
Laceyella	Bacilli	Bacillota
Candidatus Rhabdochlamydia	Chlamydiia	Chlamydiota
Microbaculum	Alphaproteobacteria	Pseudomonadota
Caldicellulosiruptor	Clostridia	Bacillota
Anaerobiospirillum	Gammaproteobacteria	Pseudomonadota
Anaerosoma	Coriobacteriia	Actinomycetota
Caloramator	Clostridia	Bacillota
Lachnoclostridium	Clostridia	Bacillota
Agarivorans	Gammaproteobacteria	Pseudomonadota
Dolosigranulum	Bacilli	Bacillota
Limibaculum	Alphaproteobacteria	Pseudomonadota
Parvivirga	Coriobacteriia	Actinomycetota
Flintibacter	Clostridia	Bacillota
Vermiculatibacterium	Clostridia	Bacillota
Nitrobacter	Alphaproteobacteria	Pseudomonadota
Gilvimarinus	Gammaproteobacteria	Pseudomonadota
Paucimonas	Betaproteobacteria	Pseudomonadota
Lutimaribacter	Alphaproteobacteria	Pseudomonadota
Oxalobacter	Betaproteobacteria	Pseudomonadota
Alkaliflexus	Bacteroidia	Bacteroidota
Paraconexibacter	Thermoleophilia	Actinomycetota
Curtanaerobium	Coriobacteriia	Actinomycetota
Lichenifustis	Alphaproteobacteria	Pseudomonadota
Berkiella	Gammaproteobacteria	Pseudomonadota
Thermalbibacter	Thermomicrobia	Thermomicrobiota
Brachyspira	Spirochaetia	Spirochaetota
Hephaestia	Alphaproteobacteria	Pseudomonadota
Ancylothrix	Cyanophyceae	Cyanobacteriota
Thermoleophilum	Thermoleophilia	Actinomycetota
Syntrophotalea	Desulfuromonadia	Thermodesulfobacteriota
Futiania	Alphaproteobacteria	Pseudomonadota
Alkalimarinus	Gammaproteobacteria	Pseudomonadota
Aquiflexum	Cytophagia	Bacteroidota
Chitinolyticbacter	Betaproteobacteria	Pseudomonadota
Aestuariibaculum	Flavobacteriia	Bacteroidota
Protaetiibacter	Actinomycetes	Actinomycetota
Frigidibacter	Alphaproteobacteria	Pseudomonadota
Fontisphaera	Verrucomicrobiae	Verrucomicrobiota
Govania	Alphaproteobacteria	Pseudomonadota
Oryzihumus	Actinomycetes	Actinomycetota
Marortus	Gammaproteobacteria	Pseudomonadota
Aldersonia	Actinomycetes	Actinomycetota
Pigmentibacter	Oligoflexia	Bdellovibrionota
Winslowiella	Gammaproteobacteria	Pseudomonadota
Silvimonas	Betaproteobacteria	Pseudomonadota
Alkalihalobacterium	Bacilli	Bacillota
Catenovulum	Gammaproteobacteria	Pseudomonadota
Aedoeadaptatus	Tissierellia	Bacillota
Brotonthovivens	Clostridia	Bacillota
Anthropogastromicrobium	Clostridia	Bacillota
Paraflavisolibacter	Chitinophagia	Bacteroidota
Plectonema	Cyanophyceae	Cyanobacteriota
Lawsonibacter	Clostridia	Bacillota
Gaoshiqia	Bacteroidia	Bacteroidota
Pedococcus	Actinomycetes	Actinomycetota
Limobrevibacterium	Alphaproteobacteria	Pseudomonadota
Prosthecochloris	Chlorobiia	Chlorobiota
Mangrovivirga	Cytophagia	Bacteroidota
Stigmatella	Myxococcia	Myxococcota
Parathalassolituus	Gammaproteobacteria	Pseudomonadota
Thermodesulfomicrobium	Desulfovibrionia	Thermodesulfobacteriota
NA	Dehalococcoidia	Chloroflexota
Cerasicoccus	Opitutae	Verrucomicrobiota
Roseofilum	Cyanophyceae	Cyanobacteriota
NA	Desulfobulbia	Thermodesulfobacteriota
Thomasclavelia	Erysipelotrichia	Bacillota
Dinoroseobacter	Alphaproteobacteria	Pseudomonadota
Jeotgalibaca	Bacilli	Bacillota
Spongiactinospora	Actinomycetes	Actinomycetota
Microbacter	Bacteroidia	Bacteroidota
Aliiglaciecola	Gammaproteobacteria	Pseudomonadota
Tissierella	Tissierellia	Bacillota
Brooklawnia	Actinomycetes	Actinomycetota
Klugiella	Actinomycetes	Actinomycetota
Litchfieldia	Bacilli	Bacillota
Bermanella	Gammaproteobacteria	Pseudomonadota
Proteiniborus	Clostridia	Bacillota
Thermomicrobium	Thermomicrobia	Thermomicrobiota
Alloyangia	Alphaproteobacteria	Pseudomonadota
Anaerovirgula	Clostridia	Bacillota
Nitrococcus	Gammaproteobacteria	Pseudomonadota
Congregibacter	Gammaproteobacteria	Pseudomonadota
Thermochromatium	Gammaproteobacteria	Pseudomonadota
Syntrophus	Syntrophia	Thermodesulfobacteriota
Prochlorothrix	Cyanophyceae	Cyanobacteriota
Pedosphaera	Verrucomicrobiae	Verrucomicrobiota
Pelodictyon	Chlorobiia	Chlorobiota
Thiorhodococcus	Gammaproteobacteria	Pseudomonadota
Propionimicrobium	Actinomycetes	Actinomycetota
Phascolarctobacterium	Negativicutes	Bacillota
Zymobacter	Gammaproteobacteria	Pseudomonadota
Simkania	Chlamydiia	Chlamydiota
Solibacter	Terriglobia	Acidobacteriota
Desulfosalsimonas	Desulfobacteria	Thermodesulfobacteriota
Halospina	Gammaproteobacteria	Pseudomonadota
Goodfellowiella	Actinomycetes	Actinomycetota
Syntrophobacter	Syntrophobacteria	Thermodesulfobacteriota
Olleya	Flavobacteriia	Bacteroidota
Candidatus Karelsulcia	Flavobacteriia	Bacteroidota
Rhodonellum	Cytophagia	Bacteroidota
Polymorphospora	Actinomycetes	Actinomycetota
Contubernalis	Dethiobacteria	Bacillota
Catenuloplanes	Actinomycetes	Actinomycetota
Candidatus Phytoplasma	Mollicutes	Mycoplasmatota
Aeribacillus	Bacilli	Bacillota
Acidobacterium	Terriglobia	Acidobacteriota
Caryophanon	Bacilli	Bacillota
Luteococcus	Actinomycetes	Actinomycetota
Rhodobium	Alphaproteobacteria	Pseudomonadota
Liberibacter	Alphaproteobacteria	Pseudomonadota
Actinoalloteichus	Actinomycetes	Actinomycetota
Paludibacter	Bacteroidia	Bacteroidota
Micavibrio	Bdellovibrionia	Bdellovibrionota
NA	Rubrobacteria	Actinomycetota
Krasilnikovia	Actinomycetes	Actinomycetota
Heliorestis	Clostridia	Bacillota
Heliophilum	Clostridia	Bacillota
Dactylosporangium	Actinomycetes	Actinomycetota
Bilophila	Desulfovibrionia	Thermodesulfobacteriota
Crenothrix	Gammaproteobacteria	Pseudomonadota
Bellilinea	Anaerolineae	Chloroflexota
Longilinea	Anaerolineae	Chloroflexota
Nonlabens	Flavobacteriia	Bacteroidota
Sulfurivirga	Gammaproteobacteria	Pseudomonadota
Granulibacter	Alphaproteobacteria	Pseudomonadota
Pelosinus	Negativicutes	Bacillota
Dermabacter	Actinomycetes	Actinomycetota
Mycoplasma	Mollicutes	Mycoplasmatota
Marinovum	Alphaproteobacteria	Pseudomonadota
Terrisporobacter	Clostridia	Bacillota
Oceanidesulfovibrio	Desulfovibrionia	Thermodesulfobacteriota
Zhihengliuella	Actinomycetes	Actinomycetota
Paeniroseomonas	Alphaproteobacteria	Pseudomonadota
Calditerricola	Bacilli	Bacillota
Halothermothrix	Clostridia	Bacillota
Gulbenkiania	Betaproteobacteria	Pseudomonadota
Paraliomyxa	Myxococcia	Myxococcota
Desulfuromusa	Desulfuromonadia	Thermodesulfobacteriota
Halotalea	Gammaproteobacteria	Pseudomonadota
Zhouia	Flavobacteriia	Bacteroidota
Syntrophomonas	Clostridia	Bacillota
Trabulsiella	Gammaproteobacteria	Pseudomonadota
Candidatus Brocadia	Candidatus Brocadiia	Planctomycetota
Parapusillimonas	Betaproteobacteria	Pseudomonadota
Thiohalorhabdus	Gammaproteobacteria	Pseudomonadota
Thiohalophilus	Gammaproteobacteria	Pseudomonadota
Panacagrimonas	Gammaproteobacteria	Pseudomonadota
Gluconobacter	Alphaproteobacteria	Pseudomonadota
Nitratiruptor	Epsilonproteobacteria	Campylobacterota
Megasphaera	Negativicutes	Bacillota
Modicisalibacter	Gammaproteobacteria	Pseudomonadota
Plesiocystis	NA	Myxococcota
Halochromatium	Gammaproteobacteria	Pseudomonadota
Nubsella	Sphingobacteriia	Bacteroidota
Rhizorhabdus	Alphaproteobacteria	Pseudomonadota
Microterricola	Actinomycetes	Actinomycetota
Donghicola	Alphaproteobacteria	Pseudomonadota
Roseinatronobacter	Alphaproteobacteria	Pseudomonadota
Salirhabdus	Bacilli	Bacillota
Gallionella	Betaproteobacteria	Pseudomonadota
Fulvivirga	Cytophagia	Bacteroidota
Pseudobacteroides	Clostridia	Bacillota
Methylohalomonas	Gammaproteobacteria	Pseudomonadota
Lapillicoccus	Actinomycetes	Actinomycetota
Desulforhopalus	Desulfobulbia	Thermodesulfobacteriota
Haloactinospora	Actinomycetes	Actinomycetota
Actinosynnema	Actinomycetes	Actinomycetota
Phaeovulum	Alphaproteobacteria	Pseudomonadota
Thioploca	Gammaproteobacteria	Pseudomonadota
Succiniclasticum	Negativicutes	Bacillota
Ewingella	Gammaproteobacteria	Pseudomonadota
Varibaculum	Actinomycetes	Actinomycetota
Natronocella	Gammaproteobacteria	Pseudomonadota
Thiohalomonas	Gammaproteobacteria	Pseudomonadota
Ferrovum	Betaproteobacteria	Pseudomonadota
Litorivicinus	Gammaproteobacteria	Pseudomonadota
Candidatus Microthrix	Acidimicrobiia	Actinomycetota
Microthrix	Acidimicrobiia	Actinomycetota
Calidifontibacter	Actinomycetes	Actinomycetota
Candidatus Epulonipiscium	Clostridia	Bacillota
Lactonifactor	Clostridia	Bacillota
Cucumibacter	Alphaproteobacteria	Pseudomonadota
Spirilliplanes	Actinomycetes	Actinomycetota
Georgfuchsia	Betaproteobacteria	Pseudomonadota
Natronincola	Clostridia	Bacillota
Desulfurivibrio	Desulfobulbia	Thermodesulfobacteriota
Dethiobacter	Dethiobacteria	Bacillota
Fodinicola	Actinomycetes	Actinomycetota
Acidomonas	Alphaproteobacteria	Pseudomonadota
Methylomarinum	Gammaproteobacteria	Pseudomonadota
Pseudosporangium	Actinomycetes	Actinomycetota
Tranquillimonas	Alphaproteobacteria	Pseudomonadota
Acanthopleuribacter	Holophagae	Acidobacteriota
Ameyamaea	Alphaproteobacteria	Pseudomonadota
Pelotalea	Desulfuromonadia	Thermodesulfobacteriota
Candidatus Nitrotoga	Betaproteobacteria	Pseudomonadota
Allopusillimonas	Betaproteobacteria	Pseudomonadota
Roseibacillus	Verrucomicrobiae	Verrucomicrobiota
Chthonomonas	Chthonomonadetes	Armatimonadota
Pyrinomonas	Blastocatellia	Acidobacteriota
Methylonatrum	Gammaproteobacteria	Pseudomonadota
Glaciecola	Gammaproteobacteria	Pseudomonadota
Desulfonema	Desulfobacteria	Thermodesulfobacteriota
Rivibacter	Betaproteobacteria	Pseudomonadota
Chloracidobacterium	Blastocatellia	Acidobacteriota
Neptuniibacter	Gammaproteobacteria	Pseudomonadota
Terribacillus	Bacilli	Bacillota
Fluoribacter	Gammaproteobacteria	Pseudomonadota
Symbiothrix	Bacteroidia	Bacteroidota
Jongsikchunia	Actinomycetes	Actinomycetota
Dethiosulfovibrio	Synergistia	Synergistota
Shimazuella	Bacilli	Bacillota
NA	Caldilineae	Chloroflexota
Lishizhenia	Flavobacteriia	Bacteroidota
Rhizomicrobium	Alphaproteobacteria	Pseudomonadota
Estrella	Chlamydiia	Chlamydiota
Prosthecobacter	Verrucomicrobiae	Verrucomicrobiota
Aquisalibacillus	Bacilli	Bacillota
Desulfofarcimen	Clostridia	Bacillota
Rhabdochromatium	Gammaproteobacteria	Pseudomonadota
Puniceispirillum	Alphaproteobacteria	Pseudomonadota
Jhaorihella	Alphaproteobacteria	Pseudomonadota
Desulfonatronospira	Desulfovibrionia	Thermodesulfobacteriota
Syntrophaceticus	Clostridia	Bacillota
Bowmanella	Gammaproteobacteria	Pseudomonadota
Rhodovastum	Alphaproteobacteria	Pseudomonadota
Dehalobacterium	Clostridia	Bacillota
Pontibaca	Alphaproteobacteria	Pseudomonadota
Tetragenococcus	Bacilli	Bacillota
Natroniella	Clostridia	Bacillota
Allomeiothermus	Deinococci	Deinococcota
Thermotalea	Clostridia	Bacillota
Thermovenabulum	Clostridia	Bacillota
Deinobacterium	Deinococci	Deinococcota
Denitrificimonas	Gammaproteobacteria	Pseudomonadota
Mitsuokella	Negativicutes	Bacillota
Pleionea	Gammaproteobacteria	Pseudomonadota
Thermobaculum	NA	Chloroflexota
Acidimicrobium	Acidimicrobiia	Actinomycetota
Krasilnikoviella	Actinomycetes	Actinomycetota
Pirellula	Planctomycetia	Planctomycetota
Pilimelia	Actinomycetes	Actinomycetota
Filifactor	Clostridia	Bacillota
Friedmanniella	Actinomycetes	Actinomycetota
Thioalbus	Gammaproteobacteria	Pseudomonadota
Phycisphaera	Phycisphaerae	Planctomycetota
Francisella	Gammaproteobacteria	Pseudomonadota
Neomicrococcus	Actinomycetes	Actinomycetota
Rugosimonospora	Actinomycetes	Actinomycetota
Salinimicrobium	Flavobacteriia	Bacteroidota
Siphonobacter	Cytophagia	Bacteroidota
Couchioplanes	Actinomycetes	Actinomycetota
Atlantibacter	Gammaproteobacteria	Pseudomonadota
Luminiphilus	Gammaproteobacteria	Pseudomonadota
Umboniibacter	Gammaproteobacteria	Pseudomonadota
Pseudoteredinibacter	Gammaproteobacteria	Pseudomonadota
Aidingimonas	Gammaproteobacteria	Pseudomonadota
Lentibacter	Alphaproteobacteria	Pseudomonadota
Morganella	Gammaproteobacteria	Pseudomonadota
Spirillospora	Actinomycetes	Actinomycetota
Oleidesulfovibrio	Desulfovibrionia	Thermodesulfobacteriota
Rubidibacter	Cyanophyceae	Cyanobacteriota
Proteus	Gammaproteobacteria	Pseudomonadota
Aminomonas	Synergistia	Synergistota
Yimella	Actinomycetes	Actinomycetota
Candidatus Thiosymbion	Gammaproteobacteria	Pseudomonadota
Acidaminococcus	Negativicutes	Bacillota
Agaricicola	Alphaproteobacteria	Pseudomonadota
Labedaea	Actinomycetes	Actinomycetota
Geoanaerobacter	Desulfuromonadia	Thermodesulfobacteriota
Parafannyhessea	Coriobacteriia	Actinomycetota
Desulfosoma	Syntrophobacteria	Thermodesulfobacteriota
Holdemania	Erysipelotrichia	Bacillota
Thiorhodovibrio	Gammaproteobacteria	Pseudomonadota
Chromatium	Gammaproteobacteria	Pseudomonadota
Chrysosporum	Cyanophyceae	Cyanobacteriota
Neptunomonas	Gammaproteobacteria	Pseudomonadota
Ornithinibacter	Actinomycetes	Actinomycetota
Shigella	Gammaproteobacteria	Pseudomonadota
Slackia	Coriobacteriia	Actinomycetota
Lutibaculum	Alphaproteobacteria	Pseudomonadota
Pseudofulvimonas	Gammaproteobacteria	Pseudomonadota
Edwardsiella	Gammaproteobacteria	Pseudomonadota
Herpetosiphon	Chloroflexia	Chloroflexota
Segniliparus	Actinomycetes	Actinomycetota
NA	Elusimicrobia	Elusimicrobiota
Allocatelliglobosispora	Actinomycetes	Actinomycetota
Desulfarculus	Desulfarculia	Thermodesulfobacteriota
Murinocardiopsis	Actinomycetes	Actinomycetota
Eoetvoesiella	Betaproteobacteria	Pseudomonadota
Grimontia	Gammaproteobacteria	Pseudomonadota
NA	Aquificae	Aquificota
Fretibacterium	Synergistia	Synergistota
Rudaeicoccus	Actinomycetes	Actinomycetota
Pacificibacter	Alphaproteobacteria	Pseudomonadota
Marivita	Alphaproteobacteria	Pseudomonadota
Chiayiivirga	Gammaproteobacteria	Pseudomonadota
Fimbriimonas	Fimbriimonadia	Armatimonadota
Pseudobacter	Chitinophagia	Bacteroidota
Prosthecomicrobium	Alphaproteobacteria	Pseudomonadota
Bauldia	Alphaproteobacteria	Pseudomonadota
Aciditerrimonas	Acidimicrobiia	Actinomycetota
Caldinitratiruptor	Clostridia	Bacillota
Branchiibius	Actinomycetes	Actinomycetota
Trujillonella	Actinomycetes	Actinomycetota
Babela	Candidatus Babeliae	NA
Microaerobacter	Bacilli	Bacillota
Auraticoccus	Actinomycetes	Actinomycetota
Tolumonas	Gammaproteobacteria	Pseudomonadota
NA	NA	Candidatus Bipolaricaulota
Desulfurispira	Chrysiogenetes	Chrysiogenota
Spinactinospora	Actinomycetes	Actinomycetota
Planosporangium	Actinomycetes	Actinomycetota
Terrimicrobium	Terrimicrobiia	Verrucomicrobiota
Tuwongella	Planctomycetia	Planctomycetota
Musicola	Gammaproteobacteria	Pseudomonadota
Mahella	Clostridia	Bacillota
Oleispira	Gammaproteobacteria	Pseudomonadota
Tindallia	Clostridia	Bacillota
Plesiomonas	Gammaproteobacteria	Pseudomonadota
Desulfomonile	Desulfomonilia	Thermodesulfobacteriota
Aliamphritea	Gammaproteobacteria	Pseudomonadota
Terrihabitans	Alphaproteobacteria	Pseudomonadota
Aurantimicrobium	Actinomycetes	Actinomycetota
Oligoflexus	Oligoflexia	Bdellovibrionota
Aggregatibacter	Gammaproteobacteria	Pseudomonadota
Kroppenstedtia	Bacilli	Bacillota
Simonsiella	Betaproteobacteria	Pseudomonadota
Actinobacillus	Gammaproteobacteria	Pseudomonadota
Histophilus	Gammaproteobacteria	Pseudomonadota
Povalibacter	Gammaproteobacteria	Pseudomonadota
Thermaerobacter	Clostridia	Bacillota
Antarctobacter	Alphaproteobacteria	Pseudomonadota
Oceanibacterium	Alphaproteobacteria	Pseudomonadota
Tepidamorphus	Alphaproteobacteria	Pseudomonadota
Thermodesulfobium	Thermodesulfobiia	Thermodesulfobiota
Paraperlucidibaca	Gammaproteobacteria	Pseudomonadota
Brevifollis	Verrucomicrobiae	Verrucomicrobiota
Alpinimonas	Actinomycetes	Actinomycetota
Aureicoccus	Flavobacteriia	Bacteroidota
Haliscomenobacter	Saprospiria	Bacteroidota
Ferribacterium	Betaproteobacteria	Pseudomonadota
Allgaiera	Alphaproteobacteria	Pseudomonadota
Lamprocystis	Gammaproteobacteria	Pseudomonadota
Thioflavicoccus	Gammaproteobacteria	Pseudomonadota
Thiorhodospira	Gammaproteobacteria	Pseudomonadota
Desulfuribacillus	Desulfuribacillia	Bacillota
Thermobacillus	Bacilli	Bacillota
Paracraurococcus	Alphaproteobacteria	Pseudomonadota
Ehrlichia	Alphaproteobacteria	Pseudomonadota
Insolitispirillum	Alphaproteobacteria	Pseudomonadota
Thermanaerovibrio	Synergistia	Synergistota
Liquorilactobacillus	Bacilli	Bacillota
Obesumbacterium	Gammaproteobacteria	Pseudomonadota
Pragia	Gammaproteobacteria	Pseudomonadota
Roseospirillum	Alphaproteobacteria	Pseudomonadota
Formivibrio	Betaproteobacteria	Pseudomonadota
Pseudoclostridium	Clostridia	Bacillota
Eggerthella	Coriobacteriia	Actinomycetota
Anaerobacillus	Bacilli	Bacillota
Amantichitinum	Betaproteobacteria	Pseudomonadota
Dactylopiibacterium	Betaproteobacteria	Pseudomonadota
Alkalispirillum	Gammaproteobacteria	Pseudomonadota
Gemmatirosa	Gemmatimonadetes	Gemmatimonadota
Marinithermus	Deinococci	Deinococcota
Thermanaerothrix	Anaerolineae	Chloroflexota
Dichelobacter	Gammaproteobacteria	Pseudomonadota
Carboxydothermus	Clostridia	Bacillota
Poseidonocella	Alphaproteobacteria	Pseudomonadota
Natronohydrobacter	Alphaproteobacteria	Pseudomonadota
Ardenticatena	Ardenticatenia	Chloroflexota
Aerococcus	Bacilli	Bacillota
Methyloferula	Alphaproteobacteria	Pseudomonadota
Megalodesulfovibrio	Desulfovibrionia	Thermodesulfobacteriota
Bernardetia	Cytophagia	Bacteroidota
Minicystis	NA	Myxococcota
Rubrimonas	Alphaproteobacteria	Pseudomonadota
Buchnera	Gammaproteobacteria	Pseudomonadota
Oligella	Betaproteobacteria	Pseudomonadota
Holophaga	Holophagae	Acidobacteriota
Longimycelium	Actinomycetes	Actinomycetota
Syntrophorhabdus	Syntrophorhabdia	Thermodesulfobacteriota
Pelolinea	Anaerolineae	Chloroflexota
Aggregatilinea	Anaerolineae	Chloroflexota
Asinibacterium	Chitinophagia	Bacteroidota
Galbibacter	Flavobacteriia	Bacteroidota
Sandaracinus	NA	Myxococcota
Mycoplasmoides	NA	Mycoplasmatota
Ketogulonicigenium	Alphaproteobacteria	Pseudomonadota
Gibbsiella	Gammaproteobacteria	Pseudomonadota
Alteribacillus	Bacilli	Bacillota
Entotheonella	NA	Candidatus Tectomicrobia
Dichotomicrobium	Alphaproteobacteria	Pseudomonadota
Caldanaerobius	Clostridia	Bacillota
Desulfurispirillum	Chrysiogenetes	Chrysiogenota
Youngiibacter	Clostridia	Bacillota
Hyella	Cyanophyceae	Cyanobacteriota
Lusitaniella	Cyanophyceae	Cyanobacteriota
Thiomargarita	Gammaproteobacteria	Pseudomonadota
Symbiobacter	Betaproteobacteria	Pseudomonadota
Wolbachia	Alphaproteobacteria	Pseudomonadota
Bacteriovorax	Bacteriovoracia	Bdellovibrionota
Desulfosudis	Desulfobacteria	Thermodesulfobacteriota
Desulfoglaeba	Syntrophobacteria	Thermodesulfobacteriota
Oxynema	Cyanophyceae	Cyanobacteriota
Candidatus Odyssella	Alphaproteobacteria	Pseudomonadota
Candidatus Megaera	Alphaproteobacteria	Pseudomonadota
Humitalea	Alphaproteobacteria	Pseudomonadota
Polymorphum	Alphaproteobacteria	Pseudomonadota
Metallibacterium	Gammaproteobacteria	Pseudomonadota
Fontibacillus	Bacilli	Bacillota
Desulfobaculum	Desulfovibrionia	Thermodesulfobacteriota
Halosaccharopolyspora	Actinomycetes	Actinomycetota
Saprospira	Saprospiria	Bacteroidota
Cryomorpha	Flavobacteriia	Bacteroidota
Solobacterium	Erysipelotrichia	Bacillota
Profundibacterium	Alphaproteobacteria	Pseudomonadota
Thermopolyspora	Actinomycetes	Actinomycetota
NA	Chloroflexia	Chloroflexota
Compostimonas	Actinomycetes	Actinomycetota
Nitriliruptor	Nitriliruptoria	Actinomycetota
Thermocatellispora	Actinomycetes	Actinomycetota
Catalinimonas	Cytophagia	Bacteroidota
Agitococcus	Gammaproteobacteria	Pseudomonadota
Pseudarcicella	Cytophagia	Bacteroidota
Hyunsoonleella	Flavobacteriia	Bacteroidota
Hydrogenispora	NA	Bacillota
Mobilicoccus	Actinomycetes	Actinomycetota
Thermicanus	Bacilli	Bacillota
Thermacetogenium	Clostridia	Bacillota
Timonella	Actinomycetes	Actinomycetota
Fonticella	Clostridia	Bacillota
Anabaenopsis	Cyanophyceae	Cyanobacteriota
NA	NA	Candidatus Sumerlaeota
Thermocrispum	Actinomycetes	Actinomycetota
Geomobilimonas	Desulfuromonadia	Thermodesulfobacteriota
Zobellia	Flavobacteriia	Bacteroidota
Anaerobranca	Clostridia	Bacillota
Atopostipes	Bacilli	Bacillota
Catelliglobosispora	Actinomycetes	Actinomycetota
Gryllotalpicola	Actinomycetes	Actinomycetota
Demetria	Actinomycetes	Actinomycetota
Desulfocurvus	Desulfovibrionia	Thermodesulfobacteriota
Desulfovirgula	Clostridia	Bacillota
Desulfurispora	Clostridia	Bacillota
Flavisolibacter	Chitinophagia	Bacteroidota
Eisenibacter	Cytophagia	Bacteroidota
Flexithrix	Cytophagia	Bacteroidota
Glaciibacter	Actinomycetes	Actinomycetota
Granulicoccus	Actinomycetes	Actinomycetota
Helcococcus	Tissierellia	Bacillota
Hespellia	Clostridia	Bacillota
Flavilitoribacter	Saprospiria	Bacteroidota
Paraoerskovia	Actinomycetes	Actinomycetota
Paucisalibacillus	Bacilli	Bacillota
Proteiniphilum	Bacteroidia	Bacteroidota
Psychroflexus	Flavobacteriia	Bacteroidota
Robiginitomaculum	Alphaproteobacteria	Pseudomonadota
Smaragdicoccus	Actinomycetes	Actinomycetota
Sporolituus	Negativicutes	Bacillota
Embleya	Actinomycetes	Actinomycetota
Thermoanaerobacter	Clostridia	Bacillota
NA	Candidatus Brocadiia	Planctomycetota
Schinkia	Bacilli	Bacillota
Melioribacter	Ignavibacteria	Ignavibacteriota
Ornatilinea	Anaerolineae	Chloroflexota
Anaerophaga	Bacteroidia	Bacteroidota
Allonocardiopsis	Actinomycetes	Actinomycetota
Dissulfuribacter	Dissulfuribacteria	Thermodesulfobacteriota
Diaminobutyricimonas	Actinomycetes	Actinomycetota
Richelia	Cyanophyceae	Cyanobacteriota
Cryocola	Actinomycetes	Actinomycetota
Aureivirga	Flavobacteriia	Bacteroidota
Gloeomargarita	Cyanophyceae	Cyanobacteriota
Nitritalea	Cytophagia	Bacteroidota
Cloacibacillus	Synergistia	Synergistota
Cycloclasticus	Gammaproteobacteria	Pseudomonadota
Propionibacterium	Actinomycetes	Actinomycetota
Salana	Actinomycetes	Actinomycetota
Soleaferrea	Clostridia	Bacillota
Prochlorococcus	Cyanophyceae	Cyanobacteriota
Alkalihalobacillus	Bacilli	Bacillota
Arcanobacterium	Actinomycetes	Actinomycetota
Phaeovibrio	Alphaproteobacteria	Pseudomonadota
Altibacter	Flavobacteriia	Bacteroidota
Okibacterium	Actinomycetes	Actinomycetota
Caldalkalibacillus	Bacilli	Bacillota
Kaistella	Flavobacteriia	Bacteroidota
Melghirimyces	Bacilli	Bacillota
Compostibacillus	Bacilli	Bacillota
Calderihabitans	Clostridia	Bacillota
Sulfuricurvum	Epsilonproteobacteria	Campylobacterota
Coprothermobacter	Coprothermobacteria	Coprothermobacterota
Garicola	Actinomycetes	Actinomycetota
Aurantibacter	Flavobacteriia	Bacteroidota
Kytococcus	Actinomycetes	Actinomycetota
Acidithrix	Acidimicrobiia	Actinomycetota
Flaviflexus	Actinomycetes	Actinomycetota
Scalindua	Candidatus Brocadiia	Planctomycetota
Desulfolucanica	Clostridia	Bacillota
NA	Erysipelotrichia	Bacillota
Melittangium	Myxococcia	Myxococcota
Luteibaculum	Flavobacteriia	Bacteroidota
Thermosulfidibacter	Aquificae	Aquificota
Dictyoglomus	Dictyoglomia	Dictyoglomota
Aminiphilus	Synergistia	Synergistota
Limisalsivibrio	Deferribacteres	Deferribacterota
Thermoanaerobaculum	Thermoanaerobaculia	Acidobacteriota
Kallotenue	Chloroflexia	Chloroflexota
Mobilisporobacter	Clostridia	Bacillota
Risungbinella	Bacilli	Bacillota
Lucifera	Negativicutes	Bacillota
Catenibacterium	Erysipelotrichia	Bacillota
Rhizorhapis	Alphaproteobacteria	Pseudomonadota
Weissella	Bacilli	Bacillota
Atopobium	Coriobacteriia	Actinomycetota
Pseudacidobacterium	Terriglobia	Acidobacteriota
Lancefieldella	Coriobacteriia	Actinomycetota
Ureibacillus	Bacilli	Bacillota
Thermoflavifilum	Chitinophagia	Bacteroidota
Patiriisocius	Flavobacteriia	Bacteroidota
Holospora	Alphaproteobacteria	Pseudomonadota
Fervidicella	Clostridia	Bacillota
Tachikawaea	Gammaproteobacteria	Pseudomonadota
Pseudobutyrivibrio	Clostridia	Bacillota
Pacificitalea	Alphaproteobacteria	Pseudomonadota
NA	NA	Gemmatimonadota
Isobaculum	Bacilli	Bacillota
Agaribacter	Gammaproteobacteria	Pseudomonadota
Salisediminibacterium	Bacilli	Bacillota
Jahnella	NA	Myxococcota
Chania	Gammaproteobacteria	Pseudomonadota
Phycosocius	Alphaproteobacteria	Pseudomonadota
Phaeacidiphilus	Actinomycetes	Actinomycetota
Cyclonatronum	Balneolia	Balneolota
Halarcobacter	Epsilonproteobacteria	Campylobacterota
Parapontixanthobacter	Alphaproteobacteria	Pseudomonadota
Parafilimonas	Chitinophagia	Bacteroidota
Dendrosporobacter	Negativicutes	Bacillota
Longimonas	Rhodothermia	Rhodothermota
Stoquefichus	Erysipelotrichia	Bacillota
Pseudogracilibacillus	Bacilli	Bacillota
Actinospica	Actinomycetes	Actinomycetota
Wenyingzhuangia	Flavobacteriia	Bacteroidota
Aquimixticola	Alphaproteobacteria	Pseudomonadota
Mesocricetibacter	Gammaproteobacteria	Pseudomonadota
Phaeodactylibacter	Saprospiria	Bacteroidota
Planktosalinus	Flavobacteriia	Bacteroidota
Rarobacter	Actinomycetes	Actinomycetota
Barrientosiimonas	Actinomycetes	Actinomycetota
Balneicella	Bacteroidia	Bacteroidota
Wenjunlia	Actinomycetes	Actinomycetota
Bradymonas	Deltaproteobacteria	NA
Limnochorda	Limnochordia	Bacillota
Acididesulfobacillus	Clostridia	Bacillota
Anaplasma	Alphaproteobacteria	Pseudomonadota
Yeosuana	Flavobacteriia	Bacteroidota
Pseudoglutamicibacter	Actinomycetes	Actinomycetota
Marinithermofilum	Bacilli	Bacillota
Falsihalocynthiibacter	Alphaproteobacteria	Pseudomonadota
Limibacillus	Alphaproteobacteria	Pseudomonadota
Ezakiella	Tissierellia	Bacillota
Desulfoplanes	Desulfovibrionia	Thermodesulfobacteriota
Latilactobacillus	Bacilli	Bacillota
Actinorugispora	Actinomycetes	Actinomycetota
Loigolactobacillus	Bacilli	Bacillota
Aliterella	Cyanophyceae	Cyanobacteriota
NA	NA	Candidatus Beckwithbacteria
NA	NA	Candidatus Azambacteria
Cnuibacter	Actinomycetes	Actinomycetota
Fructilactobacillus	Bacilli	Bacillota
Antricoccus	Actinomycetes	Actinomycetota
Chrysopegis	NA	Candidatus Kryptonia
Pontivivens	Alphaproteobacteria	Pseudomonadota
Roseicyclus	Alphaproteobacteria	Pseudomonadota
Mangrovimonas	Flavobacteriia	Bacteroidota
Saliniramus	Alphaproteobacteria	Pseudomonadota
Sellimonas	Clostridia	Bacillota
Caldimicrobium	Thermodesulfobacteria	Thermodesulfobacteriota
Rhabdobacter	Cytophagia	Bacteroidota
NA	NA	Candidatus Microgenomates
NA	NA	Candidatus Parcubacteria
Marinibacterium	Alphaproteobacteria	Pseudomonadota
Marvinbryantia	Clostridia	Bacillota
Lagierella	Tissierellia	Bacillota
Tenggerimyces	Actinomycetes	Actinomycetota
Aliikangiella	Gammaproteobacteria	Pseudomonadota
Thermanaerosceptrum	Clostridia	Bacillota
Sandaracinobacter	Alphaproteobacteria	Pseudomonadota
Levyella	Clostridia	Bacillota
Acetilactobacillus	Bacilli	Bacillota
Olivibacter	Sphingobacteriia	Bacteroidota
Peribacter	Candidatus Peribacteria	Candidatus Peregrinibacteria
Crocinitomix	Flavobacteriia	Bacteroidota
Bariatricus	Clostridia	Bacillota
Mongoliibacter	Cytophagia	Bacteroidota
NA	NA	Candidatus Daviesbacteria
NA	NA	Candidatus Jorgensenbacteria
Paraphotobacterium	Gammaproteobacteria	Pseudomonadota
Abyssisolibacter	Clostridia	Bacillota
Lipingzhangella	Actinomycetes	Actinomycetota
Arenibacter	Flavobacteriia	Bacteroidota
Puia	Chitinophagia	Bacteroidota
Pseudoroseicyclus	Alphaproteobacteria	Pseudomonadota
Echinicola	Cytophagia	Bacteroidota
Cetobacterium	Fusobacteriia	Fusobacteriota
Massilibacillus	Negativicutes	Bacillota
Zunongwangia	Flavobacteriia	Bacteroidota
NA	Balneolia	Balneolota
Abyssicoccus	Bacilli	Bacillota
Flavimaricola	Alphaproteobacteria	Pseudomonadota
Aestuariivivens	Flavobacteriia	Bacteroidota
Silicimonas	Alphaproteobacteria	Pseudomonadota
Swaminathania	Alphaproteobacteria	Pseudomonadota
Leptonema	Spirochaetia	Spirochaetota
Marseilla	Bacteroidia	Bacteroidota
Flavivirga	Flavobacteriia	Bacteroidota
Urechidicola	Flavobacteriia	Bacteroidota
Thermophilibacter	Coriobacteriia	Actinomycetota
Propionicimonas	Actinomycetes	Actinomycetota
NA	NA	Candidatus Kryptonia
NA	NA	Candidatus Gracilibacteria
Hyphococcus	Alphaproteobacteria	Pseudomonadota
Acetoanaerobium	Clostridia	Bacillota
Xanthomarina	Flavobacteriia	Bacteroidota
Arabiibacter	Coriobacteriia	Actinomycetota
Mordavella	Clostridia	Bacillota
Intestinibacillus	Clostridia	Bacillota
Mesohalobacter	Flavobacteriia	Bacteroidota
Pistricoccus	Gammaproteobacteria	Pseudomonadota
Fuerstiella	Planctomycetia	Planctomycetota
Gaetbulibacter	Flavobacteriia	Bacteroidota
Thermodesulfitimonas	Clostridia	Bacillota
Hallerella	Fibrobacteria	Fibrobacterota
Tersicoccus	Actinomycetes	Actinomycetota
Venteria	Gammaproteobacteria	Pseudomonadota
Mailhella	Desulfovibrionia	Thermodesulfobacteriota
Lactovum	Bacilli	Bacillota
Turicibacter	Erysipelotrichia	Bacillota
NA	Chlorobiia	Chlorobiota
Longicatena	Erysipelotrichia	Bacillota
Fodinibius	Balneolia	Balneolota
Fonsibacter	Alphaproteobacteria	Pseudomonadota
Vicingus	Flavobacteriia	Bacteroidota
Litorihabitans	Actinomycetes	Actinomycetota
Methylomusa	Negativicutes	Bacillota
Salegentibacter	Flavobacteriia	Bacteroidota
Rhodoglobus	Actinomycetes	Actinomycetota
Thermosulfuriphilus	Thermodesulfobacteria	Thermodesulfobacteriota
Dubosiella	Erysipelotrichia	Bacillota
Wohlfahrtiimonas	Gammaproteobacteria	Pseudomonadota
Abditibacterium	Abditibacteriia	Abditibacteriota
Geofilum	Bacteroidia	Bacteroidota
Tyzzerella	Clostridia	Bacillota
Elusimicrobium	Elusimicrobia	Elusimicrobiota
Pelagibacter	Alphaproteobacteria	Pseudomonadota
Faecalibacillus	Erysipelotrichia	Bacillota
NA	NA	Armatimonadota
Mariniblastus	Planctomycetia	Planctomycetota
Thermobispora	Actinomycetes	Actinomycetota
Alteribacter	Bacilli	Bacillota
Tengunoibacter	Ktedonobacteria	Chloroflexota
Thermocoleostomius	Cyanophyceae	Cyanobacteriota
Raineya	Cytophagia	Bacteroidota
Superficieibacter	Gammaproteobacteria	Pseudomonadota
Viridilinea	Chloroflexia	Chloroflexota
NA	Oligoflexia	Bdellovibrionota
Alkalilacustris	Alphaproteobacteria	Pseudomonadota
Mariniflexile	Flavobacteriia	Bacteroidota
NA	Fusobacteriia	Fusobacteriota
Amylibacter	Alphaproteobacteria	Pseudomonadota
NA	Nitrospiria	Nitrospirota
Candidatus Nanopelagicus	Actinomycetes	Actinomycetota
Paremcibacter	Alphaproteobacteria	Pseudomonadota
NA	NA	Chlamydiota
Koribacter	Terriglobia	Acidobacteriota
Thermosulfurimonas	Thermodesulfobacteria	Thermodesulfobacteriota
Mobiluncus	Actinomycetes	Actinomycetota
NA	NA	Candidatus Levybacteria
NA	NA	Candidatus Melainabacteria
Cuspidothrix	Cyanophyceae	Cyanobacteriota
NA	NA	Candidatus Falkowbacteria
NA	NA	Candidatus Giovannonibacteria
Fastidiosibacter	Gammaproteobacteria	Pseudomonadota
Antarcticibacterium	Flavobacteriia	Bacteroidota
Candidatus Chromulinivorax	Candidatus Babeliae	NA
Mangrovicella	Alphaproteobacteria	Pseudomonadota
Arundinibacter	Cytophagia	Bacteroidota
Solitalea	Sphingobacteriia	Bacteroidota
Oceanithermus	Deinococci	Deinococcota
Glaesserella	Gammaproteobacteria	Pseudomonadota
Pukyongia	Flavobacteriia	Bacteroidota
Duncaniella	Bacteroidia	Bacteroidota
NA	Desulfobacteria	Thermodesulfobacteriota
Spiroplasma	Mollicutes	Mycoplasmatota
Pseudoprevotella	Bacteroidia	Bacteroidota
Acholeplasma	Mollicutes	Mycoplasmatota
Lactimicrobium	Erysipelotrichia	Bacillota
Alteripontixanthobacter	Alphaproteobacteria	Pseudomonadota
Pleomorphovibrio	Cytophagia	Bacteroidota
Vulcanococcus	Cyanophyceae	Cyanobacteriota
Botryobacter	Cytophagia	Bacteroidota
Saliniradius	Gammaproteobacteria	Pseudomonadota
Moanabacter	Opitutae	Verrucomicrobiota
Koinonema	Cyanophyceae	Cyanobacteriota
Hydrogenimonas	Epsilonproteobacteria	Campylobacterota
Humibacter	Actinomycetes	Actinomycetota
Xylanibacterium	Actinomycetes	Actinomycetota
Paratractidigestivibacter	Coriobacteriia	Actinomycetota
Persicimonas	Deltaproteobacteria	NA
Hanamia	Chitinophagia	Bacteroidota
Colidextribacter	Clostridia	Bacillota
Biomaibacter	Clostridia	Bacillota
Parablautia	Clostridia	Bacillota
Propionigenium	Fusobacteriia	Fusobacteriota
Georhizobium	Alphaproteobacteria	Pseudomonadota
Flexistipes	Deferribacteres	Deferribacterota
Neoactinobaculum	Actinomycetes	Actinomycetota
Fastidiosipila	Clostridia	Bacillota
Tenuibacillus	Bacilli	Bacillota
Thermovibrio	Aquificae	Aquificota
Paracaedibacter	Alphaproteobacteria	Pseudomonadota
NA	NA	Candidatus Kapabacteria
Empedobacter	Flavobacteriia	Bacteroidota
Chryseotalea	Cytophagia	Bacteroidota
Filibacter	Bacilli	Bacillota
Spelaeibacter	Actinomycetes	Actinomycetota
Anaerophilus	Clostridia	Bacillota
Aliishimia	Alphaproteobacteria	Pseudomonadota
Hwanghaeella	Alphaproteobacteria	Pseudomonadota
Flaviaesturariibacter	Chitinophagia	Bacteroidota
Aminipila	Clostridia	Bacillota
Xylanimonas	Actinomycetes	Actinomycetota
Blochmannia	Gammaproteobacteria	Pseudomonadota
Oceanispirochaeta	Spirochaetia	Spirochaetota
Aureliella	Planctomycetia	Planctomycetota
Mucisphaera	Phycisphaerae	Planctomycetota
Allorhodopirellula	Planctomycetia	Planctomycetota
Polystyrenella	Planctomycetia	Planctomycetota
Rubripirellula	Planctomycetia	Planctomycetota
Zhaonella	Clostridia	Bacillota
Oceanihabitans	Flavobacteriia	Bacteroidota
Xanthovirga	Cytophagia	Bacteroidota
Ethanoligenens	Clostridia	Bacillota
Owenweeksia	Flavobacteriia	Bacteroidota
Cumulibacter	Actinomycetes	Actinomycetota
Siminovitchia	Bacilli	Bacillota
Rhodocaloribacter	Rhodothermia	Rhodothermota
Lentisphaera	Lentisphaeria	Lentisphaerota
Ilyomonas	Chitinophagia	Bacteroidota
Salidesulfovibrio	Desulfovibrionia	Thermodesulfobacteriota
Pelagovum	Alphaproteobacteria	Pseudomonadota
Tenuifilum	Bacteroidia	Bacteroidota
Paenalkalicoccus	Bacilli	Bacillota
Komarekiella	Cyanophyceae	Cyanobacteriota
Skermania	Actinomycetes	Actinomycetota
Qingshengfaniella	Alphaproteobacteria	Pseudomonadota
Homoserinibacter	Actinomycetes	Actinomycetota
Stecheria	Erysipelotrichia	Bacillota
Pseudoramibacter	Clostridia	Bacillota
Porcincola	Clostridia	Bacillota
Thermosynechococcus	Cyanophyceae	Cyanobacteriota
Neglectibacter	Clostridia	Bacillota
Endobacterium	Alphaproteobacteria	Pseudomonadota
Candidatus Mycosynbacter	NA	Candidatus Saccharibacteria
Allosaccharopolyspora	Actinomycetes	Actinomycetota
Parasphingorhabdus	Alphaproteobacteria	Pseudomonadota
Tellurirhabdus	Cytophagia	Bacteroidota
Sphingosinithalassobacter	Alphaproteobacteria	Pseudomonadota
Cellulophaga	Flavobacteriia	Bacteroidota
Algicella	Alphaproteobacteria	Pseudomonadota
Anaeromonas	Clostridia	Bacillota
Candidatus Pelagisphaera	Opitutae	Verrucomicrobiota
Winkia	Actinomycetes	Actinomycetota
Falsirhodobacter	Alphaproteobacteria	Pseudomonadota
Pelagihabitans	Flavobacteriia	Bacteroidota
Heliobacterium	Clostridia	Bacillota
Atopococcus	Bacilli	Bacillota
Stagnihabitans	Alphaproteobacteria	Pseudomonadota
Fangia	Gammaproteobacteria	Pseudomonadota
Candidatus Nitronauta	Nitrospinia	Nitrospinota
Candidatus Hydrogenisulfobacillus	Clostridia	Bacillota
Sulfuriroseicoccus	Verrucomicrobiae	Verrucomicrobiota
Kineobactrum	Gammaproteobacteria	Pseudomonadota
Sodalinema	Cyanophyceae	Cyanobacteriota
Phototrophicus	Candidatus Thermofonsia	Chloroflexota
Pusillibacter	Clostridia	Bacillota
Cyanaurora	Cyanophyceae	Cyanobacteriota
Ferranicluibacter	Alphaproteobacteria	Pseudomonadota
Hellea	Alphaproteobacteria	Pseudomonadota
Croceivirga	Flavobacteriia	Bacteroidota
Candidatus Cardinium	Cytophagia	Bacteroidota
Alkalicella	Clostridia	Bacillota
Thermanaeromonas	Clostridia	Bacillota
Berryella	Coriobacteriia	Actinomycetota
Palleniella	Bacteroidia	Bacteroidota
Limnobaculum	Gammaproteobacteria	Pseudomonadota
Natranaerofaba	Clostridia	Bacillota
Rhabdonatronobacter	Alphaproteobacteria	Pseudomonadota
NA	NA	Candidatus Niyogibacteria
Koleobacter	Clostridia	Bacillota
Aceticella	Clostridia	Bacillota
Pararhodonellum	Cytophagia	Bacteroidota
Changpingibacter	Actinomycetes	Actinomycetota
Croceimicrobium	Flavobacteriia	Bacteroidota
Robiginitalea	Flavobacteriia	Bacteroidota
Novosphingopyxis	Alphaproteobacteria	Pseudomonadota
Agathobaculum	Clostridia	Bacillota
Luoshenia	Clostridia	Bacillota
Bianquea	Clostridia	Bacillota
Yeguia	Clostridia	Bacillota
Wansuia	Clostridia	Bacillota
Zongyangia	Clostridia	Bacillota
Lentihominibacter	Clostridia	Bacillota
Anaerovorax	Clostridia	Bacillota
Agilicoccus	Actinomycetes	Actinomycetota
Gallalistipes	Bacteroidia	Bacteroidota
Luteirhabdus	Flavobacteriia	Bacteroidota
Qaidamihabitans	Actinomycetes	Actinomycetota
Gelria	Clostridia	Bacillota
Cupidesulfovibrio	Desulfovibrionia	Thermodesulfobacteriota
Proteiniclasticum	Clostridia	Bacillota
Szabonella	Alphaproteobacteria	Pseudomonadota
Roseitranquillus	Alphaproteobacteria	Pseudomonadota
Natronosporangium	Actinomycetes	Actinomycetota
Hoylesella	Bacteroidia	Bacteroidota
Natronogracilivirga	Balneolia	Balneolota
Paradesulfitobacterium	Clostridia	Bacillota
Arcobacter	Epsilonproteobacteria	Campylobacterota
Candidatus Arcticimaribacter	Flavobacteriia	Bacteroidota
Spiractinospora	Actinomycetes	Actinomycetota
Hongsoonwoonella	Alphaproteobacteria	Pseudomonadota
Nereida	Alphaproteobacteria	Pseudomonadota
Thermospira	Spirochaetia	Spirochaetota
Parvicella	Flavobacteriia	Bacteroidota
Bizionia	Flavobacteriia	Bacteroidota
Sinomicrobium	Flavobacteriia	Bacteroidota
Citreicoccus	Myxococcia	Myxococcota
Salsipaludibacter	Nitriliruptoria	Actinomycetota
Halomarinibacterium	Flavobacteriia	Bacteroidota
Desulfoferrobacter	Syntrophobacteria	Thermodesulfobacteriota
Xinfangfangia	Alphaproteobacteria	Pseudomonadota
Heliomarina	Alphaproteobacteria	Pseudomonadota
Mesobacterium	Alphaproteobacteria	Pseudomonadota
Robertkochia	Flavobacteriia	Bacteroidota
Schnuerera	Tissierellia	Bacillota
Candidatus Sulfidibacterium	NA	Bacteroidota
Abyssibius	Alphaproteobacteria	Pseudomonadota
Rhodoflexus	Cytophagia	Bacteroidota
Aegicerativicinus	Flavobacteriia	Bacteroidota
Granulimonas	Coriobacteriia	Actinomycetota
Subsaximicrobium	Flavobacteriia	Bacteroidota
Thermosediminibacter	Clostridia	Bacillota
Cognataquiflexum	Cytophagia	Bacteroidota
Sinobaca	Bacilli	Bacillota
Candidatus Ichthyocystis	Betaproteobacteria	Pseudomonadota
Saccharococcus	Bacilli	Bacillota
Anaerotardibacter	Coriobacteriia	Actinomycetota
Pumilibacter	Clostridia	Bacillota
Sansalvadorimonas	Gammaproteobacteria	Pseudomonadota
Parasegetibacter	Chitinophagia	Bacteroidota
Aporhodopirellula	Planctomycetia	Planctomycetota
Terrihalobacillus	Bacilli	Bacillota
Haploplasma	Mollicutes	Mycoplasmatota
Flavicella	Flavobacteriia	Bacteroidota
Brytella	Alphaproteobacteria	Pseudomonadota
Marinilongibacter	Cytophagia	Bacteroidota
Huintestinicola	Clostridia	Bacillota
Gallintestinimicrobium	Clostridia	Bacillota
Candidatus Brachybacter	Saprospiria	Bacteroidota
Candidatus Parvibacillus	Saprospiria	Bacteroidota
Hoyosella	Actinomycetes	Actinomycetota
Lentiprolixibacter	Flavobacteriia	Bacteroidota
Chondrinema	Cytophagia	Bacteroidota
Psychrosphaera	Gammaproteobacteria	Pseudomonadota
Gimibacter	Alphaproteobacteria	Pseudomonadota
Aminithiophilus	Synergistia	Synergistota
Caproicibacterium	Clostridia	Bacillota
Petralouisia	Clostridia	Bacillota
Rosenbergiella	Gammaproteobacteria	Pseudomonadota
Mariniplasma	Mollicutes	Mycoplasmatota
Pseudodonghicola	Alphaproteobacteria	Pseudomonadota
Microscilla	Cytophagia	Bacteroidota
Amedibacillus	Erysipelotrichia	Bacillota
Neoasaia	Alphaproteobacteria	Pseudomonadota
Citreimonas	Alphaproteobacteria	Pseudomonadota
Jezberella	Betaproteobacteria	Pseudomonadota
Coprococcus	Clostridia	Bacillota
Thalassobius	Alphaproteobacteria	Pseudomonadota
Melissococcus	Bacilli	Bacillota
Caldithrix	Calditrichia	Calditrichota
Pseudokineococcus	Actinomycetes	Actinomycetota
Thermostaphylospora	Actinomycetes	Actinomycetota
Leyella	Bacteroidia	Bacteroidota
Maledivibacter	Clostridia	Bacillota
Rivularia	Cyanophyceae	Cyanobacteriota
Hungatella	Clostridia	Bacillota
Thermodesulforhabdus	Syntrophobacteria	Thermodesulfobacteriota
Rippkaea	Cyanophyceae	Cyanobacteriota
Marihabitans	Actinomycetes	Actinomycetota
Alkalibacterium	Bacilli	Bacillota
Ammonifex	Clostridia	Bacillota
Terrimesophilobacter	Actinomycetes	Actinomycetota
Crocosphaera	Cyanophyceae	Cyanobacteriota
Scopulibacillus	Bacilli	Bacillota
Halolactibacillus	Bacilli	Bacillota
Ekhidna	Cytophagia	Bacteroidota
Desulforudis	Clostridia	Bacillota
Beutenbergia	Actinomycetes	Actinomycetota
Leptobacterium	Flavobacteriia	Bacteroidota
Bibersteinia	Gammaproteobacteria	Pseudomonadota
Desulfohalobium	Desulfovibrionia	Thermodesulfobacteriota
Falsibacillus	Bacilli	Bacillota
Bergeriella	Betaproteobacteria	Pseudomonadota
Gloeothece	Cyanophyceae	Cyanobacteriota
Deferribacter	Deferribacteres	Deferribacterota
Caldisericum	Caldisericia	Caldisericota
Methylacidiphilum	Methylacidiphilae	Verrucomicrobiota
Syntrophobotulus	Clostridia	Bacillota
Chloroherpeton	Chlorobiia	Chlorobiota
Sharpea	Erysipelotrichia	Bacillota
Buchananella	Actinomycetes	Actinomycetota
Lonepinella	Gammaproteobacteria	Pseudomonadota
Thermobifida	Actinomycetes	Actinomycetota
Parvimonas	Tissierellia	Bacillota
Edaphobacillus	Bacilli	Bacillota
Bogoriella	Actinomycetes	Actinomycetota
Pseudescherichia	Gammaproteobacteria	Pseudomonadota
Salinihabitans	Alphaproteobacteria	Pseudomonadota
Butyricimonas	Bacteroidia	Bacteroidota
Thermolongibacillus	Bacilli	Bacillota
Isosphaera	Planctomycetia	Planctomycetota
Paraprevotella	Bacteroidia	Bacteroidota
Thermovirga	Synergistia	Synergistota
NA	Zetaproteobacteria	Pseudomonadota
Gleimia	Actinomycetes	Actinomycetota
Desulfobacca	Desulfobaccia	Thermodesulfobacteriota
Allosphingosinicella	Alphaproteobacteria	Pseudomonadota
Pluralibacter	Gammaproteobacteria	Pseudomonadota
Candidatus Planktophila	Actinomycetes	Actinomycetota
Arsenophonus	Gammaproteobacteria	Pseudomonadota
Pricia	Flavobacteriia	Bacteroidota
Fortiea	Cyanophyceae	Cyanobacteriota
Marivirga	Cytophagia	Bacteroidota
Paraurantiacibacter	Alphaproteobacteria	Pseudomonadota
Gracilimonas	Balneolia	Balneolota
Truepera	Deinococci	Deinococcota
NA	Synergistia	Synergistota
Halothece	Cyanophyceae	Cyanobacteriota
Kosmotoga	Thermotogae	Thermotogota
Desulfonispora	Clostridia	Bacillota
Facklamia	Bacilli	Bacillota
Catenibacillus	Clostridia	Bacillota
Natranaerovirga	Clostridia	Bacillota
Algoriella	Flavobacteriia	Bacteroidota
Armatimonas	Armatimonadia	Armatimonadota
Ohtaekwangia	Cytophagia	Bacteroidota
Thermasporomyces	Actinomycetes	Actinomycetota
Basfia	Gammaproteobacteria	Pseudomonadota
Desulfonatronovibrio	Desulfovibrionia	Thermodesulfobacteriota
Rhodospira	Alphaproteobacteria	Pseudomonadota
Phytomonospora	Actinomycetes	Actinomycetota
Rubricoccus	Rhodothermia	Rhodothermota
Gracilinema	Spirochaetia	Spirochaetota
Parvibacter	Coriobacteriia	Actinomycetota
Halobacteroides	Clostridia	Bacillota
Natranaerobius	Clostridia	Bacillota
Pseudopedobacter	Sphingobacteriia	Bacteroidota
Amphibacillus	Bacilli	Bacillota
Calditerrivibrio	Deferribacteres	Deferribacterota
Orientia	Alphaproteobacteria	Pseudomonadota
Sphaerimonospora	Actinomycetes	Actinomycetota
Aminobacterium	Synergistia	Synergistota
Anaerovibrio	Negativicutes	Bacillota
Desemzia	Bacilli	Bacillota
Tatumella	Gammaproteobacteria	Pseudomonadota
Fusobacterium	Fusobacteriia	Fusobacteriota
Bryocella	Terriglobia	Acidobacteriota
Pectinatus	Negativicutes	Bacillota
Turneriella	Spirochaetia	Spirochaetota
Thermoflexus	Thermoflexia	Chloroflexota
Mageeibacillus	Clostridia	Bacillota
Desulfococcus	Desulfobacteria	Thermodesulfobacteriota
Flexibacter	Cytophagia	Bacteroidota
Brockia	Bacilli	Bacillota
Hippea	Desulfurellia	Campylobacterota
Ignavibacterium	Ignavibacteria	Ignavibacteriota
Miniimonas	Actinomycetes	Actinomycetota
Fuchsiella	Clostridia	Bacillota
Actinocrinis	Actinomycetes	Actinomycetota
Acetobacteroides	Bacteroidia	Bacteroidota
Thermohalobacter	Tissierellia	Bacillota
Ochrovirga	Flavobacteriia	Bacteroidota
Marininema	Bacilli	Bacillota
Anditalea	Cytophagia	Bacteroidota
Seleniivibrio	Deferribacteres	Deferribacterota
Commensalibacter	Alphaproteobacteria	Pseudomonadota
Portibacter	Saprospiria	Bacteroidota
Anaeromusa	Negativicutes	Bacillota
Desmospora	Bacilli	Bacillota
Desulfocicer	Desulfobacteria	Thermodesulfobacteriota
Desulfovermiculus	Desulfovibrionia	Thermodesulfobacteriota
Jonesia	Actinomycetes	Actinomycetota
Malonomonas	Desulfuromonadia	Thermodesulfobacteriota
Thermosyntropha	Clostridia	Bacillota
Thiolinea	Gammaproteobacteria	Pseudomonadota
Nafulsella	Cytophagia	Bacteroidota
Halalkalibacterium (ex Joshi et al. 2022)	Bacilli	Bacillota
Paraliobacillus	Bacilli	Bacillota
Saccharicrinis	Bacteroidia	Bacteroidota
Neokomagataea	Alphaproteobacteria	Pseudomonadota
Cribrihabitans	Alphaproteobacteria	Pseudomonadota
Lunatimonas	Cytophagia	Bacteroidota
Keratinibaculum	Tissierellia	Bacillota
Cesiribacter	Cytophagia	Bacteroidota
Spelaeicoccus	Actinomycetes	Actinomycetota
Croceitalea	Flavobacteriia	Bacteroidota
Desulforegula	Desulfobacteria	Thermodesulfobacteriota
Salinispira	Spirochaetia	Spirochaetota
Chitinivibrio	Chitinivibrionia	Fibrobacterota
Perspicuibacillus	Bacilli	Bacillota
Planktothricoides	Cyanophyceae	Cyanobacteriota
Ursidibacter	Gammaproteobacteria	Pseudomonadota
Phaseolibacter	Gammaproteobacteria	Pseudomonadota
Wocania	Flavobacteriia	Bacteroidota
Sediminibacter	Flavobacteriia	Bacteroidota
Geovibrio	Deferribacteres	Deferribacterota
Eisenbergiella	Clostridia	Bacillota
Acetothermum	NA	Candidatus Bipolaricaulota
Atelocyanobacterium	Cyanophyceae	Cyanobacteriota
Schleiferia	Flavobacteriia	Bacteroidota
Novibacillus	Bacilli	Bacillota
Spongiivirga	Flavobacteriia	Bacteroidota
Intestinibacter	Clostridia	Bacillota
Siccibacter	Gammaproteobacteria	Pseudomonadota
Cricetibacter	Gammaproteobacteria	Pseudomonadota
Lentilactobacillus	Bacilli	Bacillota
Testudinibacter	Gammaproteobacteria	Pseudomonadota
Rhodobaculum	Alphaproteobacteria	Pseudomonadota
Fermentimonas	Bacteroidia	Bacteroidota
Candidatus Kinetoplastibacterium	Betaproteobacteria	Pseudomonadota
Jiulongibacter	Cytophagia	Bacteroidota
NA	NA	Candidatus Adlerbacteria
Mesonia	Flavobacteriia	Bacteroidota
Candidatus Nitrosoglobus	Gammaproteobacteria	Pseudomonadota
Kryptonium	NA	Candidatus Kryptonia
Petrimonas	Bacteroidia	Bacteroidota
Fournierella	Clostridia	Bacillota
Alloiococcus	Bacilli	Bacillota
Trueperella	Actinomycetes	Actinomycetota
Massilibacteroides	Bacteroidia	Bacteroidota
Flexilinea	Anaerolineae	Chloroflexota
Bittarella (ex Durand et al. 2017)	Clostridia	Bacillota
Agarilytica	Gammaproteobacteria	Pseudomonadota
Emergencia	Clostridia	Bacillota
Pauljensenia	Actinomycetes	Actinomycetota
Arcticibacterium	Cytophagia	Bacteroidota
Anaerosporomusa	Negativicutes	Bacillota
Pseudothioclava	Alphaproteobacteria	Pseudomonadota
Irregularibacter	Clostridia	Bacillota
Salibacter	Flavobacteriia	Bacteroidota
Anaerosacchariphilus	Clostridia	Bacillota
Aliibacillus	Bacilli	Bacillota
Prevotellamassilia	Bacteroidia	Bacteroidota
Colibacter	Negativicutes	Bacillota
Sandaracinomonas	Cytophagia	Bacteroidota
NA	Thermomicrobia	Thermomicrobiota
Salibaculum	Alphaproteobacteria	Pseudomonadota
Bacilliculturomica	Clostridia	Bacillota
Extibacter	Clostridia	Bacillota
Lascolabacillus	Bacteroidia	Bacteroidota
Massilimicrobiota	Erysipelotrichia	Bacillota
Pseudozobellia	Flavobacteriia	Bacteroidota
Lebetimonas	Epsilonproteobacteria	Campylobacterota
Cognaticolwellia	Gammaproteobacteria	Pseudomonadota
Oceanibium	Alphaproteobacteria	Pseudomonadota
Galactobacillus	Erysipelotrichia	Bacillota
Changchengzhania	Flavobacteriia	Bacteroidota
Bowdeniella	Actinomycetes	Actinomycetota
Metamycoplasma	NA	Mycoplasmatota
Ureaplasma	NA	Mycoplasmatota
Subdoligranulum	Clostridia	Bacillota
Tepidibacter	Clostridia	Bacillota
Pueribacillus	Bacilli	Bacillota
Profundibacter	Alphaproteobacteria	Pseudomonadota
Thermaurantimonas	Flavobacteriia	Bacteroidota
Corticimicrobacter	Betaproteobacteria	Pseudomonadota
Oenococcus	Bacilli	Bacillota
Halocynthiibacter	Alphaproteobacteria	Pseudomonadota
Syntrophocurvum	Clostridia	Bacillota
Aliarcobacter	Epsilonproteobacteria	Campylobacterota
Paracaedimonas	Alphaproteobacteria	Pseudomonadota
Mesobaculum	Alphaproteobacteria	Pseudomonadota
Phytobacter	Gammaproteobacteria	Pseudomonadota
Xylanivirga	Clostridia	Bacillota
Litorirhabdus	Gammaproteobacteria	Pseudomonadota
Thiospirochaeta	Spirochaetia	Spirochaetota
Caproicibacter	Clostridia	Bacillota
Haloflavibacter	Flavobacteriia	Bacteroidota
Oliverpabstia	Clostridia	Bacillota
Alkalicaulis	Alphaproteobacteria	Pseudomonadota
Hazenella	Bacilli	Bacillota
Frackibacter	Clostridia	Bacillota
Anaerotalea	Clostridia	Bacillota
Phycobacter	Alphaproteobacteria	Pseudomonadota
Thalassobacter	Alphaproteobacteria	Pseudomonadota
Acidiluteibacter	Flavobacteriia	Bacteroidota
Puerhibacterium	Actinomycetes	Actinomycetota
Aulosira	Cyanophyceae	Cyanobacteriota
Sulfurovum	Epsilonproteobacteria	Campylobacterota
Poritiphilus	Flavobacteriia	Bacteroidota
Rhodocytophaga	Cytophagia	Bacteroidota
Nitrosophilus	Epsilonproteobacteria	Campylobacterota
Sheuella	Betaproteobacteria	Pseudomonadota
Halalkalibaculum	Balneolia	Balneolota
Amniculibacterium	Flavobacteriia	Bacteroidota
Fluviibacterium	Alphaproteobacteria	Pseudomonadota
Peptacetobacter	Clostridia	Bacillota
Rasiella	Flavobacteriia	Bacteroidota
Guopingia	Clostridia	Bacillota
Yanshouia	Clostridia	Bacillota
Qingrenia	Clostridia	Bacillota
Paratissierella	Tissierellia	Bacillota
Collibacillus	Bacilli	Bacillota
Reticulibacter	Ktedonobacteria	Chloroflexota
Mongoliitalea	Cytophagia	Bacteroidota
Thiosulfatihalobacter	Alphaproteobacteria	Pseudomonadota
Breznakiella	Spirochaetia	Spirochaetota
Peredibacter	Bacteriovoracia	Bdellovibrionota
Ornithobacterium	Flavobacteriia	Bacteroidota
Pseudaquidulcibacter	Alphaproteobacteria	Pseudomonadota
Gymnodinialimonas	Alphaproteobacteria	Pseudomonadota
Ruoffia	Bacilli	Bacillota
Sessilibacter	Gammaproteobacteria	Pseudomonadota
Bombilactobacillus	Bacilli	Bacillota
Subsaxibacter	Flavobacteriia	Bacteroidota
Allocoprobacillus	Erysipelotrichia	Bacillota
Aequitasia	Clostridia	Bacillota
Borreliella	Spirochaetia	Spirochaetota
Suilimivivens	Clostridia	Bacillota
Sediminicola	Flavobacteriia	Bacteroidota
Acidothermus	Actinomycetes	Actinomycetota
Flaviramulus	Flavobacteriia	Bacteroidota
Mastigocoleus	Cyanophyceae	Cyanobacteriota
Thermophagus	Bacteroidia	Bacteroidota
Zeaxanthinibacter	Flavobacteriia	Bacteroidota
Agathobacter	Clostridia	Bacillota
Persicitalea	Cytophagia	Bacteroidota
Franconibacter	Gammaproteobacteria	Pseudomonadota
Candidatus Amoebophilus	Cytophagia	Bacteroidota
Persicirhabdus	Verrucomicrobiae	Verrucomicrobiota
Biostraticola	Gammaproteobacteria	Pseudomonadota
Hydrogenoanaerobacterium	Clostridia	Bacillota
Nosocomiicoccus	Bacilli	Bacillota
Anseongella	Sphingobacteriia	Bacteroidota
Dasania	Gammaproteobacteria	Pseudomonadota
Aliivibrio	Gammaproteobacteria	Pseudomonadota
Alkalihalophilus	Bacilli	Bacillota
Secundilactobacillus	Bacilli	Bacillota
Rhodoluna	Actinomycetes	Actinomycetota
Gloeocapsopsis	Cyanophyceae	Cyanobacteriota
Orbus	Gammaproteobacteria	Pseudomonadota
Hasllibacter	Alphaproteobacteria	Pseudomonadota
Paracholeplasma	Mollicutes	Mycoplasmatota
Haloactinopolyspora	Actinomycetes	Actinomycetota
Leadbetterella	Cytophagia	Bacteroidota
Albibacterium	Sphingobacteriia	Bacteroidota
Regiella	Gammaproteobacteria	Pseudomonadota
Hallella	Bacteroidia	Bacteroidota
Halanaerobacter	Clostridia	Bacillota
Waddlia	Chlamydiia	Chlamydiota
Gilvibacter	Flavobacteriia	Bacteroidota
Denitrobacterium	Coriobacteriia	Actinomycetota
Peptoanaerobacter	Clostridia	Bacillota
Fannyhessea	Coriobacteriia	Actinomycetota
Chlamydia	Chlamydiia	Chlamydiota
Wolinella	Epsilonproteobacteria	Campylobacterota
Pasteuria	Bacilli	Bacillota
Ruminobacter	Gammaproteobacteria	Pseudomonadota
Apilactobacillus	Bacilli	Bacillota
Macellibacteroides	Bacteroidia	Bacteroidota
Aetherobacter	NA	Myxococcota
Thermosipho	Thermotogae	Thermotogota
Eilatimonas	Alphaproteobacteria	Pseudomonadota
Portiera	Gammaproteobacteria	Pseudomonadota
Halonatronum	Clostridia	Bacillota
Saliterribacillus	Bacilli	Bacillota
Shuttleworthia	Clostridia	Bacillota
Thermotomaculum	Holophagae	Acidobacteriota
Breznakibacter	Bacteroidia	Bacteroidota
Caldifermentibacillus	Bacilli	Bacillota
Alloprevotella	Bacteroidia	Bacteroidota
Succinispira	Negativicutes	Bacillota
Metasolibacillus	Bacilli	Bacillota
Arhodomonas	Gammaproteobacteria	Pseudomonadota
Dethiosulfatibacter	Tissierellia	Bacillota
Eudoraea	Flavobacteriia	Bacteroidota
Seinonella	Bacilli	Bacillota
Parasporobacterium	Clostridia	Bacillota
Sediminihabitans	Actinomycetes	Actinomycetota
Bulleidia	Erysipelotrichia	Bacillota
Indibacter	Cytophagia	Bacteroidota
Desulfospira	Desulfobacteria	Thermodesulfobacteriota
Allosediminivita	Alphaproteobacteria	Pseudomonadota
Salinivirga	Bacteroidia	Bacteroidota
Aureispira	Saprospiria	Bacteroidota
Anoxybacter	Clostridia	Bacillota
Falseniella	Bacilli	Bacillota
Entomohabitans	Gammaproteobacteria	Pseudomonadota
Lachnospira	Clostridia	Bacillota
Holzapfeliella	Bacilli	Bacillota
Acetatifactor	Clostridia	Bacillota
Chishuiella	Flavobacteriia	Bacteroidota
Hanstruepera	Flavobacteriia	Bacteroidota
Defluviitalea	Clostridia	Bacillota
Candidatus Stoquefichus	Erysipelotrichia	Bacillota
Labilibacter	Bacteroidia	Bacteroidota
Gottschalkia	Tissierellia	Bacillota
Pseudobacteriovorax	Oligoflexia	Bdellovibrionota
Baia	Bacilli	Bacillota
Halodesulfovibrio	Desulfovibrionia	Thermodesulfobacteriota
Abiotrophia	Bacilli	Bacillota
Pseudohalocynthiibacter	Alphaproteobacteria	Pseudomonadota
Pelagirhabdus	Bacilli	Bacillota
Anaerobium	Clostridia	Bacillota
Actinotignum	Actinomycetes	Actinomycetota
Merdimonas	Clostridia	Bacillota
Caenibacillus	Bacilli	Bacillota
Pseudoponticoccus	Alphaproteobacteria	Pseudomonadota
Monaibacterium	Alphaproteobacteria	Pseudomonadota
Pseudoprimorskyibacter	Alphaproteobacteria	Pseudomonadota
Adiutrix	Desulfarculia	Thermodesulfobacteriota
Breznakia	Erysipelotrichia	Bacillota
Sediminivirga	Actinomycetes	Actinomycetota
Vaginella	Flavobacteriia	Bacteroidota
Reichenbachiella	Cytophagia	Bacteroidota
Millionella	Bacteroidia	Bacteroidota
Ndongobacter	NA	Bacillota
Criibacterium	Clostridia	Bacillota
Tokpelaia	Alphaproteobacteria	Pseudomonadota
NA	Kiritimatiellia	Kiritimatiellota
Izhakiella	Gammaproteobacteria	Pseudomonadota
Ponticoccus	Alphaproteobacteria	Pseudomonadota
Parenemella	Actinomycetes	Actinomycetota
Volucribacter	Gammaproteobacteria	Pseudomonadota
NA	Fibrobacteria	Fibrobacterota
Mycoplasmopsis	NA	Mycoplasmatota
Paramuribaculum	Bacteroidia	Bacteroidota
Allisonella	Negativicutes	Bacillota
Similichlamydia	Chlamydiia	Chlamydiota
Nanogingivalis	Candidatus Nanosyncoccalia	Candidatus Saccharibacteria
Evtepia	Clostridia	Bacillota
Neorickettsia	Alphaproteobacteria	Pseudomonadota
Algibacillus	Gammaproteobacteria	Pseudomonadota
Balnearium	Aquificae	Aquificota
Edaphovirga	Gammaproteobacteria	Pseudomonadota
Lentilitoribacter	Alphaproteobacteria	Pseudomonadota
NA	Thermotogae	Thermotogota
Fluviispira	Oligoflexia	Bdellovibrionota
Acidilutibacter	Tissierellia	Bacillota
Anaerobutyricum	Clostridia	Bacillota
Cytomitobacter	Alphaproteobacteria	Pseudomonadota
Heminiphilus	Bacteroidia	Bacteroidota
Waltera	Clostridia	Bacillota
Candidatus Arthromitus	Clostridia	Bacillota
Anaerofustis	Clostridia	Bacillota
Marinoscillum	Cytophagia	Bacteroidota
Lottiidibacillus	Bacilli	Bacillota
Kangsaoukella	Alphaproteobacteria	Pseudomonadota
Nanchangia	Actinomycetes	Actinomycetota
Vescimonas	Clostridia	Bacillota
Marinigracilibium	Cytophagia	Bacteroidota
Alkalibacillus	Bacilli	Bacillota
Insulibacter	Bacilli	Bacillota
Synergistes	Synergistia	Synergistota
Feifania	Clostridia	Bacillota
Qiania	Clostridia	Bacillota
Jingyaoa	Clostridia	Bacillota
Dellaglioa	Bacilli	Bacillota
Desulfomarina	Desulfobulbia	Thermodesulfobacteriota
Natronoglycomyces	Actinomycetes	Actinomycetota
Aureitalea	Flavobacteriia	Bacteroidota
Fredinandcohnia	Bacilli	Bacillota
Yangia	Alphaproteobacteria	Pseudomonadota
Acaricomes	Actinomycetes	Actinomycetota
Caniella	Coriobacteriia	Actinomycetota
Porcipelethomonas	Clostridia	Bacillota
Neopoerus	Clostridia	Bacillota
Aristaeella	Clostridia	Bacillota
Eggerthia	Erysipelotrichia	Bacillota
Vulcanibacillus	Bacilli	Bacillota
Pedomicrobium	Alphaproteobacteria	Pseudomonadota
Sediminitomix	Cytophagia	Bacteroidota
Puniceicoccus	Opitutae	Verrucomicrobiota
Thermosinus	Negativicutes	Bacillota
Jonquetella	Synergistia	Synergistota
Anoxynatronum	Clostridia	Bacillota
Saonia	Flavobacteriia	Bacteroidota
Leadbettera	Spirochaetia	Spirochaetota
Shimwellia	Gammaproteobacteria	Pseudomonadota
Roseicitreum	Alphaproteobacteria	Pseudomonadota
Soonwooa	Flavobacteriia	Bacteroidota
Succinatimonas	Gammaproteobacteria	Pseudomonadota
Coriobacterium	Coriobacteriia	Actinomycetota
Pasteurella	Gammaproteobacteria	Pseudomonadota
Taylorella	Betaproteobacteria	Pseudomonadota
Scardovia	Actinomycetes	Actinomycetota
Alkalitalea	Bacteroidia	Bacteroidota
Ignavigranum	Bacilli	Bacillota
NA	Nitriliruptoria	Actinomycetota
Meinhardsimonia	Alphaproteobacteria	Pseudomonadota
Dielma	Erysipelotrichia	Bacillota
Anaerosporobacter	Clostridia	Bacillota
Haematomicrobium	Actinomycetes	Actinomycetota
Lacticigenium	Bacilli	Bacillota
Papillibacter	Clostridia	Bacillota
Nasuia	Betaproteobacteria	Pseudomonadota
Desulforadius	Clostridia	Bacillota
NA	NA	Candidatus Calescamantes
Pustulibacterium	Flavobacteriia	Bacteroidota
Hydrogenothermus	Aquificae	Aquificota
Formosimonas	Betaproteobacteria	Pseudomonadota
Endomicrobium	Endomicrobiia	Elusimicrobiota
Candidatus Pseudothioglobus	Gammaproteobacteria	Pseudomonadota
Mucinivorans	Bacteroidia	Bacteroidota
Senegalimassilia	Coriobacteriia	Actinomycetota
Lawsonella	Actinomycetes	Actinomycetota
Eleftheria	Betaproteobacteria	Pseudomonadota
NA	NA	candidate division CPR3
NA	NA	Candidatus Yanofskybacteria
Actinobaculum	Actinomycetes	Actinomycetota
Inediibacterium	Clostridia	Bacillota
Neofamilia	Clostridia	Bacillota
Marinirhabdus	Flavobacteriia	Bacteroidota
Fenollaria	Clostridia	Bacillota
Atlanticothrix	Cyanophyceae	Cyanobacteriota
Arsenicibacter	Cytophagia	Bacteroidota
Propioniferax	Actinomycetes	Actinomycetota
Corallincola	Gammaproteobacteria	Pseudomonadota
Longibaculum	Erysipelotrichia	Bacillota
Balneola	Balneolia	Balneolota
Longibacter	Rhodothermia	Rhodothermota
Aquicoccus	Alphaproteobacteria	Pseudomonadota
Baumannia	Gammaproteobacteria	Pseudomonadota
Allofrancisella	Gammaproteobacteria	Pseudomonadota
NA	Thermodesulfobacteria	Thermodesulfobacteriota
NA	NA	Spirochaetota
NA	Hydrogenophilia	Pseudomonadota
Rubneribacter	Coriobacteriia	Actinomycetota
NA	Candidatus Dadabacteria	Thermodesulfobacteriota
Massilistercora	Clostridia	Bacillota
Phycorickettsia	Alphaproteobacteria	Pseudomonadota
Alginatibacterium	Gammaproteobacteria	Pseudomonadota
Facilibium	Gammaproteobacteria	Pseudomonadota
Hydrocarboniclastica	Gammaproteobacteria	Pseudomonadota
Adonisia	NA	Cyanobacteriota
Salinibacillus	Bacilli	Bacillota
Dokdonia	Flavobacteriia	Bacteroidota
Lunatibacter	Cytophagia	Bacteroidota
Staphylospora	Bacilli	Bacillota
Arenibacterium	Alphaproteobacteria	Pseudomonadota
Affinibrenneria	Gammaproteobacteria	Pseudomonadota
Pareuzebyella	Flavobacteriia	Bacteroidota
Hornefia	Clostridia	Bacillota
Paraferrimonas	Gammaproteobacteria	Pseudomonadota
Thiosulfativibrio	Gammaproteobacteria	Pseudomonadota
Chordicoccus	Clostridia	Bacillota
Pseudopontixanthobacter	Alphaproteobacteria	Pseudomonadota
Parasphaerochaeta	Spirochaetia	Spirochaetota
Candidatus Absconditicoccus	NA	Candidatus Absconditabacteria
Hydrogeniiclostridium	Clostridia	Bacillota
Entomomonas	Gammaproteobacteria	Pseudomonadota
Catonella	Clostridia	Bacillota
Entomospira	Spirochaetia	Spirochaetota
Paracrocinitomix	Flavobacteriia	Bacteroidota
Sangeribacter	Bacteroidia	Bacteroidota
Deferrivibrio	Deferribacteres	Deferribacterota
Intestinirhabdus	Gammaproteobacteria	Pseudomonadota
Mediannikoviicoccus	Clostridia	Bacillota
Silvania	Gammaproteobacteria	Pseudomonadota
Abyssalbus	Flavobacteriia	Bacteroidota
NA	Syntrophia	Thermodesulfobacteriota
Byssovorax	NA	Myxococcota
Senimuribacter	Clostridia	Bacillota
Mechercharimyces	Bacilli	Bacillota
Prodigiosinella	Gammaproteobacteria	Pseudomonadota
Halarsenatibacter	Clostridia	Bacillota
Riemerella	Flavobacteriia	Bacteroidota
Faecalicatena	Clostridia	Bacillota
NA	Nitrospinia	Nitrospinota
Venenivibrio	Aquificae	Aquificota
Mesoflavibacter	Flavobacteriia	Bacteroidota
Devriesea	Actinomycetes	Actinomycetota
Sporosalibacterium	Tissierellia	Bacillota
Piscibacillus	Bacilli	Bacillota
Cocleimonas	Gammaproteobacteria	Pseudomonadota
Thermocrinis	Aquificae	Aquificota
Bombiscardovia	Actinomycetes	Actinomycetota
Succinivibrio	Gammaproteobacteria	Pseudomonadota
Xylanibacter	Bacteroidia	Bacteroidota
Texcoconibacillus	Bacilli	Bacillota
Balneatrix	Gammaproteobacteria	Pseudomonadota
Psychrilyobacter	Fusobacteriia	Fusobacteriota
Tepidimicrobium	Tissierellia	Bacillota
Imtechella	Flavobacteriia	Bacteroidota
Denitrovibrio	Deferribacteres	Deferribacterota
Aquaticitalea	Flavobacteriia	Bacteroidota
Faecalicoccus	Erysipelotrichia	Bacillota
Melghiribacillus	Bacilli	Bacillota
Murimonas	Clostridia	Bacillota
Hamiltonella	Gammaproteobacteria	Pseudomonadota
Pseudooctadecabacter	Alphaproteobacteria	Pseudomonadota
Hutsoniella	Bacilli	Bacillota
Moheibacter	Flavobacteriia	Bacteroidota
Siansivirga	Flavobacteriia	Bacteroidota
Myxosarcina	Cyanophyceae	Cyanobacteriota
Psychromicrobium	Actinomycetes	Actinomycetota
Neptunitalea	Flavobacteriia	Bacteroidota
Hydrocoleum	Cyanophyceae	Cyanobacteriota
Pseudalgibacter	Flavobacteriia	Bacteroidota
Cochleicola	Flavobacteriia	Bacteroidota
Desulfotalea	Desulfobulbia	Thermodesulfobacteriota
Vaginimicrobium	Actinomycetes	Actinomycetota
Negativibacillus	NA	Bacillota
Cysteiniphilum	Gammaproteobacteria	Pseudomonadota
Desulfonauticus	Desulfovibrionia	Thermodesulfobacteriota
Croceibacter	Flavobacteriia	Bacteroidota
Nanosyncoccus	Candidatus Nanosyncoccalia	Candidatus Saccharibacteria
Meridianimaribacter	Flavobacteriia	Bacteroidota
Cerasibacillus	Bacilli	Bacillota
Halocella	Clostridia	Bacillota
Silvanigrella	Oligoflexia	Bdellovibrionota
Poriferisphaera	Phycisphaerae	Planctomycetota
Constantimarinum	Flavobacteriia	Bacteroidota
Pontimicrobium	Flavobacteriia	Bacteroidota
Ostreibacterium	Gammaproteobacteria	Pseudomonadota
Profftella	Betaproteobacteria	Pseudomonadota
Persicobacter	Cytophagia	Bacteroidota
Nibribacter	Cytophagia	Bacteroidota
Oceanipulchritudo	Opitutae	Verrucomicrobiota
Frischella	Gammaproteobacteria	Pseudomonadota
Pontibrevibacter	Alphaproteobacteria	Pseudomonadota
Congzhengia	Clostridia	Bacillota
Thetidibacter	Alphaproteobacteria	Pseudomonadota
Canibacter	Actinomycetes	Actinomycetota
Pseudoneobacillus	Bacilli	Bacillota
Suttonella	Gammaproteobacteria	Pseudomonadota
Candidatus Synchoanobacter	Gammaproteobacteria	Pseudomonadota
Otoolea	Clostridia	Bacillota
NA	NA	Campylobacterota
Costertonia	Flavobacteriia	Bacteroidota
Caminibacter	Epsilonproteobacteria	Campylobacterota
Celerinatantimonas	Gammaproteobacteria	Pseudomonadota
Arthrospira	Cyanophyceae	Cyanobacteriota
Jejuia	Flavobacteriia	Bacteroidota
Thermobrachium	Clostridia	Bacillota
Zymomonas	Alphaproteobacteria	Pseudomonadota
Natronoflexus	Bacteroidia	Bacteroidota
Planktotalea	Alphaproteobacteria	Pseudomonadota
Mannheimia	Gammaproteobacteria	Pseudomonadota
Budvicia	Gammaproteobacteria	Pseudomonadota
Centipeda	Negativicutes	Bacillota
Metalysinibacillus	Bacilli	Bacillota
Aliicoccus	Bacilli	Bacillota
Filobacillus	Bacilli	Bacillota
Defluviitoga	Thermotogae	Thermotogota
Basilea	Betaproteobacteria	Pseudomonadota
Algicola	Gammaproteobacteria	Pseudomonadota
Brackiella	Betaproteobacteria	Pseudomonadota
Proteocatella	Clostridia	Bacillota
Woodsholea	Alphaproteobacteria	Pseudomonadota
Photodesmus	Gammaproteobacteria	Pseudomonadota
Methylacidiphilum (ex Ratnadevi et al. 2023)	Methylacidiphilae	Verrucomicrobiota
Litorimonas	Alphaproteobacteria	Pseudomonadota
Succinimonas	Gammaproteobacteria	Pseudomonadota
Marinibactrum	Gammaproteobacteria	Pseudomonadota
Anaeromicrobium	Clostridia	Bacillota
Ghiorsea	Zetaproteobacteria	Pseudomonadota
Paenactinomyces	Bacilli	Bacillota
Paludifilum	Bacilli	Bacillota
Faecalibaculum	Erysipelotrichia	Bacillota
Xiphinematobacter	Spartobacteria	Verrucomicrobiota
Senegalia	Clostridia	Bacillota
Pseudenterobacter	Gammaproteobacteria	Pseudomonadota
Pajaroellobacter	NA	Myxococcota
Marispirochaeta	Spirochaetia	Spirochaetota
Vaginisenegalia	Bacilli	Bacillota
Neptunicella	Gammaproteobacteria	Pseudomonadota
Petrocella	Clostridia	Bacillota
Mesoplasma	Mollicutes	Mycoplasmatota
Litorilituus	Gammaproteobacteria	Pseudomonadota
NA	Candidatus Babeliae	NA
Culicoidibacter	Culicoidibacteria	Bacillota
Maribrevibacterium	Gammaproteobacteria	Pseudomonadota
Cochlodiniinecator	Alphaproteobacteria	Pseudomonadota
Marnyiella	Flavobacteriia	Bacteroidota
Snuella	Flavobacteriia	Bacteroidota
Radiobacillus	Bacilli	Bacillota
Diplocloster	Clostridia	Bacillota
Lapidilactobacillus	Bacilli	Bacillota
Caedibacter	Gammaproteobacteria	Pseudomonadota
Dryocola	Gammaproteobacteria	Pseudomonadota
Hominisplanchenecus	Clostridia	Bacillota
Thermocaproicibacter	Clostridia	Bacillota
Chelonobacter	Gammaproteobacteria	Pseudomonadota
Candidatus Azobacteroides	Bacteroidia	Bacteroidota
Ponticaulis	Alphaproteobacteria	Pseudomonadota
Hodgkinia	Alphaproteobacteria	Pseudomonadota
Marisediminitalea	Gammaproteobacteria	Pseudomonadota
Allopseudospirillum	Gammaproteobacteria	Pseudomonadota
Paraeggerthella	Coriobacteriia	Actinomycetota
Catenisphaera	Erysipelotrichia	Bacillota
Romeria	Cyanophyceae	Cyanobacteriota
Weeksella	Flavobacteriia	Bacteroidota
Baaleninema	Cyanophyceae	Cyanobacteriota
Moranella	Gammaproteobacteria	Pseudomonadota
Cruoricaptor	Flavobacteriia	Bacteroidota
Allofustis	Bacilli	Bacillota
Prochloron	Cyanophyceae	Cyanobacteriota
Schleiferilactobacillus	Bacilli	Bacillota
Selenihalanaerobacter	Clostridia	Bacillota
Teretinema	Spirochaetia	Spirochaetota
Planctobacterium	Gammaproteobacteria	Pseudomonadota
Massilibacterium	Bacilli	Bacillota
Olegusella	Coriobacteriia	Actinomycetota
Provencibacterium	Clostridia	Bacillota
Arenivirga	Actinomycetes	Actinomycetota
NA	NA	Candidatus Marinimicrobia
Parendozoicomonas	Gammaproteobacteria	Pseudomonadota
Raphidiopsis	Cyanophyceae	Cyanobacteriota
Persephonella	Aquificae	Aquificota
Profftia	Gammaproteobacteria	Pseudomonadota
Chondrocystis	Cyanophyceae	Cyanobacteriota
Scatolibacter	Clostridia	Bacillota
Cyanothece	Cyanophyceae	Cyanobacteriota
Deianiraea	Alphaproteobacteria	Pseudomonadota
Ulvibacterium	Flavobacteriia	Bacteroidota
Ichthyobacterium	Flavobacteriia	Bacteroidota
Absicoccus	Erysipelotrichia	Bacillota
Soehngenia	Tissierellia	Bacillota
Litoribacter	Cytophagia	Bacteroidota
Pseudofrancisella	Gammaproteobacteria	Pseudomonadota
Pallidibacillus	Bacilli	Bacillota
Actirhodobacter	Alphaproteobacteria	Pseudomonadota
Fibrivirga	Cytophagia	Bacteroidota
NA	Chitinivibrionia	Fibrobacterota
Candidatus Clavichlamydia	Chlamydiia	Chlamydiota
Arthronema	Cyanophyceae	Cyanobacteriota
Muribacter	Gammaproteobacteria	Pseudomonadota
Joostella	Flavobacteriia	Bacteroidota
Umezakia	Cyanophyceae	Cyanobacteriota
Steffania	Gammaproteobacteria	Pseudomonadota
Haloglycomyces	Actinomycetes	Actinomycetota
Propionicicella	Actinomycetes	Actinomycetota
Chrysiogenes	Chrysiogenetes	Chrysiogenota
Paraclostridium	Clostridia	Bacillota
Drancourtella	Clostridia	Bacillota
Muricomes	Clostridia	Bacillota
Ihubacter	Clostridia	Bacillota
Merdibacter	Erysipelotrichia	Bacillota
Thaumasiovibrio	Gammaproteobacteria	Pseudomonadota
Candidatus Pelagibacter	Alphaproteobacteria	Pseudomonadota
Candidatus Pseudoruminococcus	Clostridia	Bacillota
Agrilactobacillus	Bacilli	Bacillota
Aequoribacter	Gammaproteobacteria	Pseudomonadota
Amedibacterium	Erysipelotrichia	Bacillota
Syntrophosphaera	Candidatus Cloacimonadia	Candidatus Cloacimonadota
Candidatus Azoamicus	Gammaproteobacteria	Pseudomonadota
Fundicoccus	Bacilli	Bacillota
Sporofaciens	Clostridia	Bacillota
Iocasia	Clostridia	Bacillota
Candidatus Sarmatiella	Alphaproteobacteria	Pseudomonadota
Kandleria	Erysipelotrichia	Bacillota
Ktedonospora	Ktedonobacteria	Chloroflexota
Candidatus Gromoviella	Alphaproteobacteria	Pseudomonadota
Sabulibacter	Cytophagia	Bacteroidota
Tenebrionicola	Gammaproteobacteria	Pseudomonadota
Brucepastera	Spirochaetia	Spirochaetota
Allobacillus	Bacilli	Bacillota
Candidatus Comchoanobacter	Gammaproteobacteria	Pseudomonadota
Candidatus Nitrosacidococcus	Gammaproteobacteria	Pseudomonadota
Laedolimicola	Clostridia	Bacillota
NA	NA	Mycoplasmatota
Ilyobacter	Fusobacteriia	Fusobacteriota
Paenochrobactrum	Alphaproteobacteria	Pseudomonadota
Planktomarina	Alphaproteobacteria	Pseudomonadota
Nitratifractor	Epsilonproteobacteria	Campylobacterota
Thermosporothrix	Ktedonobacteria	Chloroflexota
Parascardovia	Actinomycetes	Actinomycetota
Gayadomonas	Gammaproteobacteria	Pseudomonadota
Anaeroarcus	Negativicutes	Bacillota
Schwartzia	Negativicutes	Bacillota
Thorsellia	Gammaproteobacteria	Pseudomonadota
Candidatus Carsonella	Gammaproteobacteria	Pseudomonadota
Frederiksenia	Gammaproteobacteria	Pseudomonadota
Malacoplasma	NA	Mycoplasmatota
Litoribacterium	Bacilli	Bacillota
Gudongella	Tissierellia	Bacillota
NA	NA	Candidatus Gottesmanbacteria
Hugonella	Coriobacteriia	Actinomycetota
Frisingicoccus	Clostridia	Bacillota
Alterileibacterium	Clostridia	Bacillota
Faecalimonas	Clostridia	Bacillota
Pygmaiobacter	Clostridia	Bacillota
Candidatus Nanosynsacchari	Candidatus Saccharimonadia	Candidatus Saccharibacteria
Halalkalibacillus	Bacilli	Bacillota
Candidatus Thioglobus	Gammaproteobacteria	Pseudomonadota
Luxibacter	Clostridia	Bacillota
Pontimonas	Actinomycetes	Actinomycetota
Furfurilactobacillus	Bacilli	Bacillota
Alloscardovia	Actinomycetes	Actinomycetota
Mangrovibacillus	Bacilli	Bacillota
Nicoletella	Gammaproteobacteria	Pseudomonadota
Hujiaoplasma	Candidatus Izimaplasma	Mycoplasmatota
Candidatus Vesicomyosocius	Gammaproteobacteria	Pseudomonadota
Zhenpiania	Clostridia	Bacillota
Solibaculum	Clostridia	Bacillota
Savagea	Bacilli	Bacillota
Chlamydiifrater	Chlamydiia	Chlamydiota
Anaerocaecibacter	Clostridia	Bacillota
Lawsonia	Desulfovibrionia	Thermodesulfobacteriota
Tractidigestivibacter	Coriobacteriia	Actinomycetota
Brotomerdimonas	Clostridia	Bacillota
Faecalitalea	Erysipelotrichia	Bacillota
Natronobacillus	Bacilli	Bacillota
Kistimonas	Gammaproteobacteria	Pseudomonadota
Natribacillus	Bacilli	Bacillota
Vidania	Betaproteobacteria	Pseudomonadota
Pseudoscardovia	Actinomycetes	Actinomycetota
Salsuginibacillus	Bacilli	Bacillota
Flavimarina	Flavobacteriia	Bacteroidota
Candidatus Paracaedibacter	Alphaproteobacteria	Pseudomonadota
Fructobacillus	Bacilli	Bacillota
Sanguibacteroides	Bacteroidia	Bacteroidota
Racemicystis	NA	Myxococcota
Oharaeibacter	Alphaproteobacteria	Pseudomonadota
Anaeroplasma	Mollicutes	Mycoplasmatota
Ningiella	Gammaproteobacteria	Pseudomonadota
Mucispirillum	Deferribacteres	Deferribacterota
Nautilia	Epsilonproteobacteria	Campylobacterota
Inconstantimicrobium	Clostridia	Bacillota
Chazhemtobacterium	NA	NA
Gallibacter	Clostridia	Bacillota
Bacterioplanoides	Gammaproteobacteria	Pseudomonadota
Falcatimonas	Clostridia	Bacillota
Tannockella	Erysipelotrichia	Bacillota
Sebaldella	Fusobacteriia	Fusobacteriota
Oxobacter	Clostridia	Bacillota
Candidatus Ruthturnera	Gammaproteobacteria	Pseudomonadota
Fervidicola	Clostridia	Bacillota
Acetohalobium	Clostridia	Bacillota
Micropelagos	Alphaproteobacteria	Pseudomonadota
Pseudoleptotrichia	Fusobacteriia	Fusobacteriota
NA	NA	Candidatus Amesbacteria
Zooshikella	Gammaproteobacteria	Pseudomonadota
Candidatus Marinarcus	Epsilonproteobacteria	Campylobacterota
Pelagibaculum	Gammaproteobacteria	Pseudomonadota
Scrofimicrobium	Actinomycetes	Actinomycetota
Copranaerobaculum	Erysipelotrichia	Bacillota
Jutongia	Clostridia	Bacillota
Vampirococcus	NA	Candidatus Absconditabacteria
Hominibacterium	Clostridia	Bacillota
Anaeropeptidivorans	Clostridia	Bacillota
Opacimonas	Gammaproteobacteria	Pseudomonadota
Oceanotoga	Thermotogae	Thermotogota
Lepagella	Bacteroidia	Bacteroidota
Hydrogenobaculum	Aquificae	Aquificota
Hydrogenivirga	Aquificae	Aquificota
Aminicella	Clostridia	Bacillota
Cloacimonas	Candidatus Cloacimonadia	Candidatus Cloacimonadota
Hirschia	Alphaproteobacteria	Pseudomonadota
NA	NA	Elusimicrobiota
Dolosicoccus	Bacilli	Bacillota
Ichthyocystis	Betaproteobacteria	Pseudomonadota
Oceanivirga	Fusobacteriia	Fusobacteriota
Pseudocolwellia	Gammaproteobacteria	Pseudomonadota
Phoenicibacter	Coriobacteriia	Actinomycetota
Simulacricoccus	Myxococcia	Myxococcota
Curvivirga	Alphaproteobacteria	Pseudomonadota
Paenihalocynthiibacter	Alphaproteobacteria	Pseudomonadota
Fervidibacillus	Bacilli	Bacillota
Euzebyella	Flavobacteriia	Bacteroidota
Hugenholtzia	Cytophagia	Bacteroidota
Pseudothermotoga	Thermotogae	Thermotogota
Gabonia	Bacteroidia	Bacteroidota
Mobilibacterium	Clostridia	Bacillota
Konateibacter	Clostridia	Bacillota
Fritschea	Chlamydiia	Chlamydiota
Anaerosphaera	Tissierellia	Bacillota
Baileyella	Clostridia	Bacillota
Claveliimonas	Clostridia	Bacillota
Waterburya	Cyanophyceae	Cyanobacteriota
Psychrobium	Gammaproteobacteria	Pseudomonadota
Gabonibacter	Bacteroidia	Bacteroidota
Methylosulfonomonas	Alphaproteobacteria	Pseudomonadota
Haloplasma	Mollicutes	Mycoplasmatota
Gullanella	Gammaproteobacteria	Pseudomonadota
Floricoccus	Bacilli	Bacillota
Floccifex	Erysipelotrichia	Bacillota
Ructibacterium	Clostridia	Bacillota
Conservatibacter	Gammaproteobacteria	Pseudomonadota
Ohessyouella	Clostridia	Bacillota
Annwoodia	Betaproteobacteria	Pseudomonadota
Pisciglobus	Bacilli	Bacillota
Enteractinococcus	Actinomycetes	Actinomycetota
Saccharibacter	Alphaproteobacteria	Pseudomonadota
Pseudostreptobacillus	Fusobacteriia	Fusobacteriota
Hepatobacter	Alphaproteobacteria	Pseudomonadota
NA	Ardenticatenia	Chloroflexota
Vespertiliibacter	Gammaproteobacteria	Pseudomonadota
Candidatus Berkiella	Gammaproteobacteria	Pseudomonadota
Youxingia	Clostridia	Bacillota
Candidatus Riesia	Gammaproteobacteria	Pseudomonadota
Clostridiisalibacter	Tissierellia	Bacillota
Mesoaciditoga	Thermotogae	Thermotogota
NA	NA	Deinococcota
Athalassotoga	Thermotogae	Thermotogota
NA	Blastocatellia	Acidobacteriota
Bergeyella	Flavobacteriia	Bacteroidota
Thermokryptus	NA	Candidatus Kryptonia
Harryflintia	Clostridia	Bacillota
Ileibacterium	Erysipelotrichia	Bacillota
Nardonella	Gammaproteobacteria	Pseudomonadota
Tropheryma	Actinomycetes	Actinomycetota
Anaerolactibacter	Erysipelotrichia	Bacillota
Saccharobesus	Gammaproteobacteria	Pseudomonadota
Aeriscardovia	Actinomycetes	Actinomycetota
Candidatus Bipolaricaulis	NA	Candidatus Bipolaricaulota
Candidatus Scalindua	Candidatus Brocadiia	Planctomycetota
Intestinibaculum	Erysipelotrichia	Bacillota
Caldanaerobacter	Clostridia	Bacillota
Pinguicoccus	NA	Verrucomicrobiota
Aggregatimonas	Flavobacteriia	Bacteroidota
Suipraeoptans	Clostridia	Bacillota
Velocimicrobium	Clostridia	Bacillota
Bullifex	Spirochaetia	Spirochaetota
Streptobacillus	Fusobacteriia	Fusobacteriota
Peptidiphaga	Actinomycetes	Actinomycetota
Fumia	Clostridia	Bacillota
Caviibacterium	Gammaproteobacteria	Pseudomonadota
Geotoga	Thermotogae	Thermotogota
Lientehia	Clostridia	Bacillota
NA	NA	Bdellovibrionota
Anammoxoglobus	Candidatus Brocadiia	Planctomycetota
Andreesenia	Tissierellia	Bacillota
Euhalothece	Cyanophyceae	Cyanobacteriota
Phaselicystis	NA	Myxococcota
Thalassobium	Alphaproteobacteria	Pseudomonadota
NA	NA	candidate division NC10
Kofleria	NA	Myxococcota
Anaeroglobus	Negativicutes	Bacillota
Ferrithrix	Acidimicrobiia	Actinomycetota
Necropsobacter	Gammaproteobacteria	Pseudomonadota
Rubidus	Chlamydiia	Chlamydiota
Phocoenobacter	Gammaproteobacteria	Pseudomonadota
Sulfopaludibacter	Terriglobia	Acidobacteriota
Bilifractor	Clostridia	Bacillota
Jilunia	Bacteroidia	Bacteroidota
Nanosynbacter	Candidatus Saccharimonadia	Candidatus Saccharibacteria
Syngnamydia	Chlamydiia	Chlamydiota
Johnsonella	Clostridia	Bacillota
Metachlamydia	Chlamydiia	Chlamydiota
Yaniella	Actinomycetes	Actinomycetota
Endolissoclinum	Alphaproteobacteria	Pseudomonadota
NA	Spartobacteria	Verrucomicrobiota
Parasaccharibacter	Alphaproteobacteria	Pseudomonadota
Candidatus Fukatsuia	Gammaproteobacteria	Pseudomonadota
Miniphocaeibacter	Tissierellia	Bacillota
NA	Desulfurellia	Campylobacterota
Caecibacteroides	Bacteroidia	Bacteroidota
Leptogranulimonas	Coriobacteriia	Actinomycetota
Candidatus Magnetobacterium	Nitrospiria	Nitrospirota
Purcelliella	Gammaproteobacteria	Pseudomonadota
Neoehrlichia	Alphaproteobacteria	Pseudomonadota
Phorcysia	Aquificae	Aquificota
Beduini	Erysipelotrichia	Bacillota
NA	NA	Candidatus Curtissbacteria
Suicoccus	Bacilli	Bacillota
Candidatus Fritschea	Chlamydiia	Chlamydiota
Entomoplasma	Mollicutes	Mycoplasmatota
Moellerella	Gammaproteobacteria	Pseudomonadota
Simiaoa	Clostridia	Bacillota
Muricoprocola	Clostridia	Bacillota
Limnospira	Cyanophyceae	Cyanobacteriota
Zophobihabitans	Gammaproteobacteria	Pseudomonadota
Hoaglandella	Gammaproteobacteria	Pseudomonadota
Amylolactobacillus	Bacilli	Bacillota
Bisgaardia	Gammaproteobacteria	Pseudomonadota
Aureisphaera	Flavobacteriia	Bacteroidota
NA	NA	candidate division Zixibacteria
Traorella	Erysipelotrichia	Bacillota
Flocculibacter	Gammaproteobacteria	Pseudomonadota
Holtiella	Clostridia	Bacillota
Marinosulfonomonas	Alphaproteobacteria	Pseudomonadota
Eremococcus	Bacilli	Bacillota
Culturomica	Bacteroidia	Bacteroidota
Candidatus Blochmannia	Gammaproteobacteria	Pseudomonadota
Penaeicola	Cytophagia	Bacteroidota
Midichloria	Alphaproteobacteria	Pseudomonadota
Otariodibacter	Gammaproteobacteria	Pseudomonadota
Actinomarina	Actinomycetes	Actinomycetota
Cyanomargarita	Cyanophyceae	Cyanobacteriota
Candidatus Vallotia	Betaproteobacteria	Pseudomonadota
Entomobacter	Alphaproteobacteria	Pseudomonadota
Ishikawaella	Gammaproteobacteria	Pseudomonadota
Acidithiomicrobium	Acidimicrobiia	Actinomycetota
Tremblaya	Betaproteobacteria	Pseudomonadota
Morococcus	Betaproteobacteria	Pseudomonadota
Evansia	Gammaproteobacteria	Pseudomonadota
Paludirhabdus	Bacilli	Bacillota
Schneideria	Gammaproteobacteria	Pseudomonadota
NA	Chrysiogenetes	Chrysiogenota
NA	Candidatus Cloacimonadia	Candidatus Cloacimonadota
Riesia	Gammaproteobacteria	Pseudomonadota
Jidaibacter	Alphaproteobacteria	Pseudomonadota
Aquifex	Aquificae	Aquificota
Candidatus Hydrogenosomobacter	Alphaproteobacteria	Pseudomonadota
Aquarickettsia	Alphaproteobacteria	Pseudomonadota
Xianfuyuplasma	Candidatus Izimaplasma	Mycoplasmatota
Hepatoplasma	Mollicutes	Mycoplasmatota
Wigglesworthia	Gammaproteobacteria	Pseudomonadota
Atopobacter	Bacilli	Bacillota
Nanoperiomorbus	Candidatus Nanoperiomorbia	Candidatus Saccharibacteria
Nesciobacter	Alphaproteobacteria	Pseudomonadota
Endoecteinascidia	Gammaproteobacteria	Pseudomonadota
Reidiella	Gammaproteobacteria	Pseudomonadota
Thioalkalibacter	Gammaproteobacteria	Pseudomonadota
Bavariicoccus	Bacilli	Bacillota
NA	NA	Kiritimatiellota
Caedimonas	Alphaproteobacteria	Pseudomonadota
Sporanaerobacter	Tissierellia	Bacillota
Candidatus Piscichlamydia	Chlamydiia	Chlamydiota
Altericista	Cyanophyceae	Cyanobacteriota
Nicoliella	Bacilli	Bacillota
Caldanaerovirga	Clostridia	Bacillota
Candidatus Neoehrlichia	Alphaproteobacteria	Pseudomonadota
Canicola	Gammaproteobacteria	Pseudomonadota
NA	Syntrophorhabdia	Thermodesulfobacteriota
Cryptobacterium	Coriobacteriia	Actinomycetota
Wilmottia	Cyanophyceae	Cyanobacteriota
Muricaecibacterium	Coriobacteriia	Actinomycetota
Zinderia	Betaproteobacteria	Pseudomonadota
Alitiscatomonas	Clostridia	Bacillota
Leahibacter	Alphaproteobacteria	Pseudomonadota
Turicimonas	Betaproteobacteria	Pseudomonadota
Petalonema	Cyanophyceae	Cyanobacteriota
Arocatia	Gammaproteobacteria	Pseudomonadota
Desulfitispora	Desulfitisporia	Bacillota
Fokinia	Alphaproteobacteria	Pseudomonadota
Aestuarium	Alphaproteobacteria	Pseudomonadota
Streptohalobacillus	Bacilli	Bacillota
Anaerorhabdus	Erysipelotrichia	Bacillota
Annandia	Gammaproteobacteria	Pseudomonadota
Aggregicoccus	Myxococcia	Myxococcota
Plectolyngbya	Cyanophyceae	Cyanobacteriota
Doolittlea	Gammaproteobacteria	Pseudomonadota
Pseudaeromonas	Gammaproteobacteria	Pseudomonadota
Brevinema	Spirochaetia	Spirochaetota
Candidatus Thiobius	Gammaproteobacteria	Pseudomonadota
Alteracholeplasma	Mollicutes	Mycoplasmatota
NA	NA	Candidatus Collierbacteria
NA	Deferribacteres	Deferribacterota
Sulfotelmatobacter	Terriglobia	Acidobacteriota
Shikimatogenerans	Flavobacteriia	Bacteroidota
Daeguia	Alphaproteobacteria	Pseudomonadota
Procabacter	Betaproteobacteria	Pseudomonadota
Muriventricola	Clostridia	Bacillota
NA	NA	Candidatus Poribacteria
Renichlamydia	Chlamydiia	Chlamydiota
Symphyonema	Cyanophyceae	Cyanobacteriota
Mergibacter	Gammaproteobacteria	Pseudomonadota
Hepatincola	Alphaproteobacteria	Pseudomonadota
Macrochaete	Cyanophyceae	Cyanobacteriota
Tildeniella	Cyanophyceae	Cyanobacteriota
Smithella	Syntrophia	Thermodesulfobacteriota
Brotolimicola	Clostridia	Bacillota
Litorisediminicola	Alphaproteobacteria	Pseudomonadota
Ichthyenterobacterium	Flavobacteriia	Bacteroidota
Catellicoccus	Bacilli	Bacillota
Acidicaldus	Alphaproteobacteria	Pseudomonadota
Allohahella	Gammaproteobacteria	Pseudomonadota
Philodulcilactobacillus	Bacilli	Bacillota
Suonthocola	Clostridia	Bacillota
Bovifimicola	Clostridia	Bacillota
Marithioploca	Gammaproteobacteria	Pseudomonadota
Parasynechococcus	Cyanophyceae	Cyanobacteriota
Mikella	Gammaproteobacteria	Pseudomonadota
NA	Candidatus Thermofonsia	Chloroflexota
Candidatus Minimicrobia	NA	Candidatus Saccharibacteria
Endoriftia	Gammaproteobacteria	Pseudomonadota
Desulfoconvexum	Desulfobacteria	Thermodesulfobacteriota
Candidatus Walczuchella	Flavobacteriia	Bacteroidota
Westeberhardia	Gammaproteobacteria	Pseudomonadota
Coetzeea	Gammaproteobacteria	Pseudomonadota
Candidatus Sneabacter	Alphaproteobacteria	Pseudomonadota
Williamsoniiplasma	Mollicutes	Mycoplasmatota
Desulfocella	Desulfobacteria	Thermodesulfobacteriota
NA	NA	Lentisphaerota
Desulfocastanea	Desulfobulbia	Thermodesulfobacteriota
Ischnodemia	Gammaproteobacteria	Pseudomonadota
Thiophysa	Gammaproteobacteria	Pseudomonadota
Saccharimonas	Candidatus Saccharimonadia	Candidatus Saccharibacteria
Candidatus Nitrotheca	NA	Chloroflexota
Thermomarinilinea	Anaerolineae	Chloroflexota
Symplocastrum	Cyanophyceae	Cyanobacteriota
Alisedimentitalea	Alphaproteobacteria	Pseudomonadota
Cyrtobacter	Alphaproteobacteria	Pseudomonadota
Dechloromarinus	Gammaproteobacteria	Pseudomonadota
Alexandriicola	Alphaproteobacteria	Pseudomonadota
Maribeggiatoa	Gammaproteobacteria	Pseudomonadota
Candidatus Profftella	Betaproteobacteria	Pseudomonadota
Galliscardovia	Actinomycetes	Actinomycetota
Halioxenophilus	Gammaproteobacteria	Pseudomonadota
Rosenkranzia	Gammaproteobacteria	Pseudomonadota
Candidatus Electrothrix	Desulfobulbia	Thermodesulfobacteriota
NA	Desulfarculia	Thermodesulfobacteriota
Puchtella	Gammaproteobacteria	Pseudomonadota
Thiolamprovum	Gammaproteobacteria	Pseudomonadota
Dichloromethanomonas	Clostridia	Bacillota
Rhodocista	Alphaproteobacteria	Pseudomonadota
Pilibacter	Bacilli	Bacillota
Caviibacter	Fusobacteriia	Fusobacteriota
Phaeochromatium	Gammaproteobacteria	Pseudomonadota
Sulfotelmatomonas	Terriglobia	Acidobacteriota
Komarkovaea	Cyanophyceae	Cyanobacteriota
Geminobacterium	Cyanophyceae	Cyanobacteriota
NA	NA	Candidatus Magasanikbacteria
Niameybacter	Clostridia	Bacillota
Pycnacronema	Cyanophyceae	Cyanobacteriota
Polycladospora	Bacilli	Bacillota
Reichenowia	Alphaproteobacteria	Pseudomonadota
Trichodesmium	Cyanophyceae	Cyanobacteriota
Eucapsis	Cyanophyceae	Cyanobacteriota
Aliinostoc	Cyanophyceae	Cyanobacteriota
Heteroscytonema	Cyanophyceae	Cyanobacteriota
Kleidoceria	Gammaproteobacteria	Pseudomonadota
Azorhizophilus	Gammaproteobacteria	Pseudomonadota
Endothiovibrio	Gammaproteobacteria	Pseudomonadota
Jaaginema	Cyanophyceae	Cyanobacteriota
Hydrocoryne	Cyanophyceae	Cyanobacteriota
Calenema	Cyanophyceae	Cyanobacteriota
Piscichlamydia	Chlamydiia	Chlamydiota
Desulfothermus	Desulfovibrionia	Thermodesulfobacteriota
Paraherbaspirillum	Betaproteobacteria	Pseudomonadota
Thalassoporum	Cyanophyceae	Cyanobacteriota
Scytonematopsis	Cyanophyceae	Cyanobacteriota
Candidatus Tokpelaia	Alphaproteobacteria	Pseudomonadota
Cryptococcum	Cyanophyceae	Cyanobacteriota
Shackletoniella	Cyanophyceae	Cyanobacteriota
Kaiparowitsia	Cyanophyceae	Cyanobacteriota
Magnetananas	Desulfobacteria	Thermodesulfobacteriota
Cephalothrix	Cyanophyceae	Cyanobacteriota
NA	NA	Fusobacteriota
Pelospora	Clostridia	Bacillota
Snowella	Cyanophyceae	Cyanobacteriota
Thioalkalispira	Gammaproteobacteria	Pseudomonadota
Timaviella	Cyanophyceae	Cyanobacteriota
Massilioclostridium	Clostridia	Bacillota
Symploca	Cyanophyceae	Cyanobacteriota
Anaerocellum	Clostridia	Bacillota
Leptoelongatus	Cyanophyceae	Cyanobacteriota
Marinicrinis	Bacilli	Bacillota
Candidatus Annandia	Gammaproteobacteria	Pseudomonadota
Candidatus Aquirickettsiella	Gammaproteobacteria	Pseudomonadota
Butyribacter	Clostridia	Bacillota
Leptochromothrix	Cyanophyceae	Cyanobacteriota
NA	Methylacidiphilae	Verrucomicrobiota
Electrothrix	Desulfobulbia	Thermodesulfobacteriota
Endobugula	Gammaproteobacteria	Pseudomonadota
Stigonema	Cyanophyceae	Cyanobacteriota
Candidatus Profftia	Gammaproteobacteria	Pseudomonadota
Aschnera	Gammaproteobacteria	Pseudomonadota
Candidatus Cytomitobacter	Alphaproteobacteria	Pseudomonadota
Thioprofundum	Gammaproteobacteria	Pseudomonadota
Cymatolege	Cyanophyceae	Cyanobacteriota
Candidatus Curculioniphilus	Gammaproteobacteria	Pseudomonadota
Phaeospirillum	Alphaproteobacteria	Pseudomonadota
Kotejella	Gammaproteobacteria	Pseudomonadota
Candidatus Photodesmus	Gammaproteobacteria	Pseudomonadota
Seminibacterium	Gammaproteobacteria	Pseudomonadota
Bathyoplasma	Candidatus Izimaplasma	Mycoplasmatota
Nephrothrix	Cytophagia	Bacteroidota
Desulfofaba	Desulfobacteria	Thermodesulfobacteriota
Wujia	Clostridia	Bacillota
Nunduva	Cyanophyceae	Cyanobacteriota
Craurococcus	Alphaproteobacteria	Pseudomonadota
Trichotorquatus	Cyanophyceae	Cyanobacteriota
Amphibiichlamydia	Chlamydiia	Chlamydiota
Anagnostidinema	Cyanophyceae	Cyanobacteriota
Captivus	Alphaproteobacteria	Pseudomonadota
NA	NA	Caldisericota
